AGAAAACAGGGCCAGGTCGTGG	TTTGCGAGTACACACATTTCTGCAGAG
TCTAGACCCAACATGCTGATGGG	ATTGGCTGAAAGACACAAGTACCAATT
GCAGAAATGCATAACAGTTGAGGATAC	GCAATCCTTGTGAGCATGCAGGAAAAT
CACAGAACAGAAAAAGTTCTGCTTACTC	GGGGCAAAGGACAACTAAGAGAAAATG
TTTCTAGATCCGTCCTTCTGCTACCT	ATCCACATCCTCTGTGCAGAACTGT
TTCATCTTGAAACGATTTGCCTGGAAA	AATGCCTGCTGCAGCCCAATGCCTGTC
TCTGGTGGATTCTCCACACTGTACAT	TAGAATAGACCCGCTTCATGACTTCAG
TCCCCTAATCCTGGGACACTAGGGA	CTGGCAGTGTCCTGGAATGTCACACT
CTGTGGCCAGTACTGAGTTTTGTTATC	ATGGTGGCACCTGCCTCAACCTGCCTG
AACCACTGGCTTTGGTCTCATTAGT	GCAGCGGTTCTTCTCACAGGGGTCT
AGCAGTTTTATAGGTGGTCCTTGTAGG	AGAATGGTGGGACTTGTGTGGCCCAGG
AGTGTTCTATCGCAAAAAGAAAATATATGA	CATTCATTCCCACCTAATCTGGGTTTC
ACACAGAGAAGGACCGAGGGGGAGAA	TCTCTCCTCCCCTCCTCCTGCTTCAAA
AAATCTGTAAGCCAAGCCAAGAATCTG	AACTTCGACGATCCGTGATAGAGTAAC
TTTTTCATGCACTCTGACTCAGGATAG	CCATGAAGTTCGTGAGTTTAAACAGCT
TCAAGATTTTGGGTTGTGCTTGACA	TGATCTCTAGTAGTTGCAAAAGTGCTG
TACCTGAGAAGTCGCATCAAGTCCAA	AGACCGTGTAAATAAACTCTCCCCACC
GTAAATGCTCTCATTACCATTGGGACC	GTGCTGTTTTTAGTTAAGCAAATCTGT
CCGATCACTATATTGGCTTTGAAACTG	TTGGAGCCAGTGTTGGCTGTTTATGTC
AGATATTTCATCTCGAGATCTTGCAGG	CGTCTCTTCTGAAAAGCTGCCTAGGA
TCATTTAAATTACTGGCTGGAGATGAC	ACTCGTGCACGTGTCCGAATGACCA
CTTAATTGCTTACATTACCACAAATGTCT	TGTGTTGAGGAAATAATTCATAGGTAGCC
GCTACTCACAAATGAGGCACTGTATTT	CTACTATAATGCATTTGTGGACAATGG
AGTTTCTTGAAAAAGGACAAATTAGCC	TCTGAATTGCAAGCAATGTAGCTCAAAG
TGCAGCATATAGACTTAGATATTTTTCTGA	GGAGAGTTTATCTGCAAGGAAAATGACTG
GGCTTGTAGAGAATTAATGAAATTTTACC	AATATCACTGAAAGGTCCAGGATCTCA
AGGTGATAATTTTAGCGTAAACTCATTC	TGTGAGTGACTCCTCTCCTGCATTAA
GTTTAAAGTGACCAATATCCCAGGCAC	TTTTTGTGGACAAGCGGAAGTTGAG
AGGCACAAATAGGTTCAAAGAGCCGT	CCAAACTCCCTGAAAAGCAAATTTATT
AAAATCTCAGTGGAAGCTGTACACTTT	CGCTGGAAAGTAAATAACCTTGCAGTT
TTCTGTAATTGCTTTCCCTTTGCTTCA	ATCCACTCCCATAGAGCCATCAGAGA
AAATTTAAAATTAGCCACCTCAACACC	GCACTGAGTCTTCATTGCTGGGTTTTA
GCGTGTTCCGATTCCGTCCACAAAAATA	GAAGACAAAGAAGACACTCGATGCTAC
CACACATGCGTGCACACACAATCACAT	CGGAGGAGGAGGGGGCGGGGCATACAT
ATACGACGACTACCACCACGAGCGCTGG	CTCCCATGGACCCTTCTAACTTTGT
GTTGCCATGGCGGGATGGACCCTGT	CTCTGGGCTTAACAGAGTAAGCCCTTT
CCCCACAAGCCCAAAATATTCTACTC	CTGTGGACAGGTGGAGGCAAAGATGA
AATGTCCTGCTAAGTCCCTGCTCTTT	TATGATGCCGCCACCACCTATGGGCAT
CTTCCCAGGTACTGATCTTGATGGAAG	CACTTGAGAGCTGCTTCTAGCCAACA
CCAAAGCCCCCAAGGTTTCTGGTCTGA	CATGCCGTGGTAGGGCCGACTCTCTGAA
GGATGTGGATGGCAACATTGTTCTTC	ATGGAGGTGGTCCTGGTGGGCCCGGAG
GACCAAGAGAGCCAGCCCCCAG	GGACACAAACAGAGAAAGGGGAAAAAC
CAGGAAACCGCAAGAGCCAGCC	ACACTCTCCTTTAAACTGATCACATACC
TAGCAGAAACCTAGGTGGAGGCCCTA	GAGACCTGAAGAACCTATGGAAGTAGA
GTGAAAATGCAATGGACAGTTAAGTGC	TGTTCTTCAGGGTGTTCCCTCTAGAGA
GCCTTTCTGTGAGAAGGTGTCTTAACT	AGAGAAGGAGTGCAATGCCAAGATTAT
ATTCTATATCCTATAGACCAGCAGTTACTC	CCAAGTGCTAATTATGGGTGACTTGAGG
AAAAAGCTGGAAGAGGAGCGGCACAACCT	ACCAATATTTGGTTTTAGAAAAGCCGC
CGGATTGAGTGCAACCATCTCTGTGAT	CCTAATACAACACTCTTCGGAGGAACC
ACTGTCAGCTGGTTAAAACTGTTTCCC	TTTGAAAGGGACGACTGATCAGTGAAC
AAAGTGCATTTGGATGCAGAACGT	AAGGTACTACACAGAAACTCAGCAGAC
CGCCTCTCGCGCTCTCTCGGCCCGACT	GGAAGGCCGCGGTCAGGGCCCCCATC
AAGGAGAAGCCGCCGCAGAGGAAAAG	TTCGCGGCGCTGCCTCCGCCGCCT
AAAATTTTTCATTTTGGCTTTTCAGCC	TGAACTGTACCGAATGTCTACGTATTCC
GCTTTTCAGTAGGACTGTCTCCTCTTTTC	CGTGTTGGCGCTTTTCATCAAATTTG
ACTGGTGTGAATGACAAGGTCAAATGC	ACTTCCGGGTACAGAAAACAGTGGAT
TGGCCATGTCTGAAAAGTAAGTAATCT	AGGAAAAGTAGGCTGAGAGGTAGCTTC
CAAGATTTTTCTGCCTTGATGAGAAGTTCC	AAGGATAATGCTATGTCAGAACACCTG
CTTACCCACATAATAAAAACCCGCACT	CTCAATTTTCCACCACAGGCAAAGCAA
TGTTCTAGTTAATCCTGAGCAGCTTGC	GGTGTTGGGAATCTGGAGATGATCCAT
TCTTCGTTGTCTTAAGTCCATCGAAAC	GAGTCCACCATCACAGCAAAAGCATTT
TCATTTCACTTGTATAAATAATCCCTCAAA	GCTATTTGAGTGAAAAGACAAGAGTTG
GGGTCATTTTCATTGCAATGGGTAAGA	ATGCATTTTCAAATATACTGTGTTGGT
TCCTAATATGTGTTAAATTCTTTGTTCCA	AATAAGGGAAGAGGAGAGAGAAAGAGC
ACATTTTTGACTTATGAGCAACTCAAAT	CATCTTCTGCATTGAGTAAGTCTAACA
TTGAACATGTTTATGCTTGTTTTCTTTTT	TACGATTTTAGTAAAAGGAAATATTGCAGC
TGAGTCACCACATTCAGCCTGAATTAT	CAATCAGTTCTCTTGCTTGTAAAGACG
TCATAGTAATGCTTTTTCTTTTTCTCCC	CAATTGCGGAGACTACAAGAAGAAAGA
GACGATGTTTTGGTTCTTCTTCATGAA	TCTTCCACTGGTAGATCTAGAAAGAGG
CAATCAAGGGTACAGTTCGTACATTTC	ACGAAAAAGAGGTAGCACTACAAACAC
GAGGTAGAGGTTGTGGTGATACGAGAT	AAAGGAAGAAAATAGAACTAGGCTGGG
AGGTTTGGGGGTAGACAAATGACTTAG	GCAAGGGACACTGTAATCACTAGATTC
AACTTCCTGATCTCTCTCGCTGTGA	GCTGTACCCTTTAGCGTAACCTTGCTA
GAGCCGGCCCAGCTGCTCGGAGGCTCT	ATGATGGAGCCTGGCCGGGGGCGAAA
GGGTCCTATGACTTTTCTCTCCCTCAA	GATGGTTTTACTTGAGCATTGGGTTGG
TGCTCAGTATCTCTTCCTTTACTCATTTCC	CCTCAGAAAACCCTGTCAGTTTAGCT
GGTTGGTTTCTGTCTTCTTTGTATCCA	AGCCATGTACTCAGCTCTTCTAGTTTC
CCTTCCCCCTCCTCTTTCTTCGG	GGGAGGCATAGGTGGGAATAAGATG
AATGGTGGTCAAGGCCCCTTTTCCAAAG	TATTCCAGCCCCAGTAAATAGTCCCCT
TGATAGTTAAATCTTTGGGGTGAGGAGAG	AGTCCTTGGCCTTCCCTTAGTCTCTAA
CAGCCTCTTGTTTGACTAGAACTGTGA	AAGTGGATGGGATAGGAGCCATCAGT
CTGTGACTGACTGTGTTATCTTTTCCC	CTCCATTCTTGCTCTCCTCCTGGA
TTCCAGGGGCTGGGTGGCCTCCAACA	ACTTCAGGGGCTGGCTGGTTTCTCTAT
GAGCCAGGTGGGAGTGAAGATTGTGAT	GTGTGACCTCTGAAGGGCAGAAAAA
AACTGAGGCCAGACCTCTCTGGTTCTGG	CAGATCTTCAAACCCCTCCTGAGAG
GCCACAGCAGGAGGAGGAGGAATCAAA	GGAACAGGCCATGAAGATGGTGGTCA
GTGTTGTGTCAGATACCTTTCCTTTCC	ATGAGGCATTGGAGGGGACAGCCTGGA
TATCCCCACCCCACTCCTACCCTCTAT	GTCCAGGGTCTCTGTTCTCTGTCTA
GAGGGTCCATAACAAAGCAAAGACAAG	TTTGTGTTCTCAGGGTTCCCAAGTCCC
GCCTCACCCTGATCCTGTGGCT	TATCCCTTTCCCTTTCTTTACTGGACC
CAATGCCCGCGGAACCTCCTGCCTGTCTTT	ATACGCTGCCTGTTCTTTCTGTGCCTA
ACTCTCCCTATAACTGGCCTCTCCCT	CGGCTCCTGTCCTCGGCCCAGC
CATCCATCCTGTATCCATCCATAACCC	TAGTAGGGGGTGCAGAGAGGCTGGCAG
CCACAGTCCTGTGGATCTCTTCCAGA	TGCCGCACTGGACGCAGGCAACATCAA
TTAGGGTCTGGGCTTCTACCACCATCC	AAGTCCTCAAAGGCCGTGTTCACCTC
TGTCTTGCTCCATTCCTTCTCACTCA	AGCGGGAGAAGGAGGAGGCACGCAGGAT
TCAGTGGTGAAGCACCGCTGCCCTCAG	AGCTGAGGAAAGAAGGGACACGGAA
GTAGCCTGGCCCCAAGCACCCCTCAA	GTCCGTGAGCGTTTTGTGTGTGACTCA
ACTGAGGTCTCTGTTGAACTGGTCT	TAGGCCCCACTCAGCCTGGCCTGGAC
AAAACAACCCAGCTTCACCCCATGTCC	AAATCTGGCTTTGCCTCCCTTTCTCAG
ATCCTCTCAGTCTGGGACAACAGTTCT	ATCAGCAGATACATGTCAGTGCAGAGG
GGGACTTAGTAGGGATTTTTCTATCTC	AGAGTGAGACAGACCCTGAGGAGAAA
AAAGGCACAGTTCACCCTTAGCCTGCA	AGGACTATTCTGTAAGAGTCCAGAGCC
ACGCTGGTCAAGCTTCCACGGCCCTTA	CTCAGACTTCTTCCTTAGTCTGGTCTG
AGGGATGAAGTCCTTAAAACTAAATTGTTC	ATGCACATGTTATGCGCCCATATTAC
AAGCTTTATAAAGTCCTGGCTGCTACA	ATGTTTGTTTTGTGGCAAGTCCTCTAC
CAACCAAATTACAGTCTGACTTGAACT	AAACACGTATTGAGATCTGCCATGTGC
AGCCAAGGGAGGCCAGCAGCTG	AATGCATCATCTTCCTAAGACCACTCT
GAGAAAAGGCAGACTTTAAGGGATACA	AAAATAGAGCCAGTCTTCACTTTTGCC
CATTTCCATTTTAAAGTGCTACTACTTAGA	TTAAAAGCACACCATCCATTTGTCCAT
TAAGCGTTTCACCATCCTTCTTTTT	TTAGGAAATGGCTTCATGCTTTCAGAC
TAATTACGAAACCCTGACCCAGCCT	TAGCAGACAACATACTCTTAGGAGGGC
TGAGGTGATTTTCGTGGAAGTGGGTT	AATTCAAAATTATGAGAGAAGCCAGGC
CTTTGTTGCTGTCCTTCCACTATACTG	CTCTTGGAAACTCCCATTTGAGATCAT
GGAAAGAATAATGAATTTTTACCTTTGCT	ATTTTCAGTCCTAACAACCACTCTACA
GGTGGAATATCACAAGAACAACTGTTG	TGAGCTGTCATCAGATTGGAAGTTAGG
TCCATTATAAGAGGCATCAATGTCCTT	ACCAATACTTTGTGAAGCCAAGGTGG
ATAAAAATCAAATTCTCGGCAATTTAACTT	CCTTGAAATGCTCCTCACTTGCTAAAG
ATGGTATCTTAGAGTCCTTTGTGGTCTC	ATTCATAGGGAAACGTATTGAGAAGAT
TAAAGATTGTGTGAGCAGCCTGCA	TTGCATTTAATGTTTTCAATCCAGACT
CTCCTCAGACCACATTGCCACAATTAT	CTCTGTTTTATTAAAACCTAGGGCAAC
ATCCATAAGGGTTCCCCTACTTTAAGA	TGACTCCTCTTTTATGAAGAAATCAGC
CTGAAAATGAAAGTGCATGATATTATAGTG	CTAGAGCCAGTTTTAAGGGTCAAATGG
TAGAATCCTTTTCTGAGGGGCTGCTA	GACACATCCATGGTAGCTGCTATTCT
TGGAATACTAGTAGCAGGCTGGACTT	ACTAAAAAGGCAGTTTGGTACTCCAGC
TTTATGTCAAGAAGGTATTCCTCCACT	CGGGGATTCTGATACCTACGTTGCAGATA
GTCCGTACAACATTTTAGAAATGCAGC	AAGACCTCGGGTGTGCGTTGAGACCCC
TCTCTAGAGAAAAACAGCTAAAGGTATAA	CTTGCAACCAAACAACAAAACAAAGTG
GAGGGGCTGCGAGCGAGCGAGC	AGGGACCGAGGCGGGAGCGGAGAGGTT
GGAGTTGGAAGCGCGTTACCCG	CGAGGTATCGGTGACTAAGCACTGATT
TTGACTTGTGCTCCCCACTTTGGAA	CCTTCTGGCCTGGTCATGGCCAGAAA
AGATGGAGGTTGCACACCAGCCTGG	TTGTGGGAGACCTTGAACACCACACCG
AAAACCTCTCTTTCTTCCACCTTTCTCC	ATCTTTGGTCTGGGAGGTGACCAGCTA
CACTAACTGGTCTGGTATTCTCGATCT	CTTCCCTGTCTGGAGTCTATATACACT
TTTTCTTTTCTTTTACATTCCCTTTCCTC	CTCCTACCCTCTTTTTGGTCTTGCTAC
AAGAATGAACTGTAAGGCCTGGACTATG	GAGTAAAGAGGTCTTTTCTCTGCCTCA
CCCTCCTTTTCTATTTTCTCTTCCCTGC	GTCTTGTGCTGGGTAGGGGACAAGAA
TGATTATCACTGTCTGTCTCTCCTGC	GTGAGTAGCCTGGTGTGTCCCCATCTT
TGTTTATTGTCCATGACCCTGTTCTGG	CTTCACCTTGGAATTTACTTGCTCATC
GGCATTTTTCTTATCTCAACATGTGTTTGC	TTAGAGTGCCAAGACTTATGTGGCATG
CAGCTCTTACCTTGTCTTTCTTCCTTT	AATACCAAACACCAGTCTCCTTTGCTC
CACCACGTCCTCTCGTTTCCTTACAT	GTGACAAAGGATGAAGAACACAGCATG
GATCACACATTAAGTGGGTAAACTATAAA	CGTAGCTGCCCTGGTAGGTTTTCT
CAAGCAATGGATGATTTGATGCTGTCC	TTTCCGTCTGGGCTTCTTGCATTCTGG
CAGTGAACCATTGTTCAATATCGTCCG	ATGGAATTTTCGCTTCCCACAGGTCT
TGACCCAGGGTTGGAAGTGTCTCATG	GGACTGACTTTCTGCTCTTGTCTTTCA
CTGCAAGAGGAAAAGTGGGGATCCA	TTGAGGAAAAGACAATCAGAGAGGGAC
TGGGAGCCTGCACTCCACAGAC	GGGGACAGAGTAGGTGAGGGGAGGTA
TTTAAGGATAAGCTGTTAACGTGTTTTT	TTGGGTTACTGTGTTTTGGGGAATTTG
CAGAAAGTGAAACTAACTTTTATGTTCTG	CAGTCCTATGGACTTTTGTCTGAGACA
CTAGGTGGTGTGTATGTAAGGTGTTCA	TGCCTCTGGGGTTTTATTTTCTCTCAG
GAGGGGCAAAAGAACTTGTCTCAAAAA	AATTCCGAAGTTCAGCTGCATGCTGGT
CCTGTCCCCTAATACTTAATTTGATAAGT	ATTGTGCTGAACTAGAACACCAAACTG
TTGCTCTGAGTTGTATTTGTGTTAACT	AGTTATGACTTGAGTGATAGTTTCACA
CAATCGTATCCTTACCAGCCATATCAG	TTTGATTCAGGATGCTAACAACAGCAA
TTTACAAAACTGTACCAGATCCCACAG	CTCTTCCTTTCCTTGGAGCAAACAAAG
AGGGATTTTGTTCCTATCTAATAATGTCA	AGGTAAGGAGGGCAAAATTATTTCCAT
TCATTGCCTGGTATTATTTTCCCTCTG	ATTCATGTTGTTTTCATCAACCACGTC
AGCTACATCTGGAATAGAAGAAACTTC	GGTGGTTGATCTTAAGGTAACATGCTT
GGTGTTTTCTTCATATTCTCAGTCCAT	TGGACTGAACAAGTAGGAAAATGACAG
TAAAGGCTTTTGTTTTCTGTTGGGGTT	TAGAGATTAATAGGTTCACTTTTATCGGT
TGGAGTGAATTTACCAGCACATAGTGA	AGTCTTTTTGTTTATAAAGGATAACAGCA
GCCTGGCTCAGAATTCACCTTCTACAT	CATATTAAGTCTTGACCGAAGGGACCA
TTTTCTTCCTATTGGTCTTTGTTTTTCTC	GTCTTTATCCTATTCCTGCTGCTTTGG
TGTCTGATACCATGTTTTTGTTTTGTT	AATTGGGTTTAGCTGAAACGCCAAGAC
ACCCTTTAGCAGTCACTGTCTATTTCT	GGAGGTAAGGGGAAAATGAATTCCATG
TGCTATGTGATACAAAGCAAGTAAACC	TTGCTTCCTGAGCAATCTCTGGCATGT
TGAGTCTTCTCTTTGTCTTTCTCTTTT	AACTTACACTTCCAAAGGTTTTATGGT
TGCTAGTAACAATGAACTTTATGTTACTGC	GGTTCTATTTCAGCTTCTCCTTCCTCC
TCAGTGCTTCAGTAAAGCTTATTTATTTA	CAGCTTCTTCTGTACTTTTTCTGTATC
GCAAATATATGTCTTCCACCCTTGACTC	TTCATGGAGTTTGCCTCTGTCAGCAA
AGCATATTAACAACTCAGTGGAAGACT	GTGTTATAGTTGGGCAAGAGGTTATGC
GTAACTTGATTTGCTGTTGTATTTGCT	AAATCCAAGATACGTGCATATTACAAG
GGCTTTTGGATAGTTAAGGATTAGCTT	CTTCAAAAGCTATTCCTGATCACACAT
TACACATGCAAAATGGGAACAAGCAAC	ATGTGGTAGCTACTAGCTATGTGTGAC
TCATGCTTTGCACAAAAATTTTGTGTT	TATGATTTCAGTGATGTCTTCAGAGGG
CACTTTACCTGTCCTTGGGAGTCAAAA	AACCCTTACGTTCACTGACTGGACCCA
ACAAATTGAAGAATACCATCAGCAAGT	TCTTAGGAACTCTGGTGTGTATGTGTG
TGGCAAATCATTAATGTATTTGTTCTTTC	AACCTCTTACACACTGATACTGGTAGT
TGCCTTCTCTTTTGTCTATATCTGATAAT	GTACAGAAAAAGAGTAGATATGCGGTT
GCTGTTTCTCTTTTCTCCACCATTCT	TTGAGATGTCAAACTTTTGTGTTTGAA
ACTTGAAAGATTCATGGTCTCTAAATTTT	TACCCATGACAGGACTAGGATAGGAAA
ACTATGTAAAGGTCAGTCTTTTTATTTCTC	CACTCCATAGGTGAGATCAAATGAAAG
GCCTTGTTGAAGGATTTTTGTCAGAACT	ATGAGACCACTGTCTACGTTGGCATTG
ATCTCCAGACAAGAGCTACATTTATGG	GTGATTAGAGTAAGCGGGGAAGAAAAG
TGCACTAACCTGATTTTGTTTTGTTCTC	ATGTACAGAATGTGCAGGGCTGATTG
TGTGAAAAGATGACAAACCTGGTAGGA	ATCATTACTTGACATACCTCAGCACAC
ATTGGCAACATGTTAGCTTTGAAGTGG	GGGACAAACTAGAGAAAGGTGTCTTTG
TCTACACGTTGCACTTGGCTTAATGTC	AGGTATGCTTACAGTTAGAGATTACCA
TCTCTTACTTCAAACTGTTGCCTAAGT	GTATAAACAGTGGCACACACTTCGAAG
GACTTGTTTGTGCTCATCTCTGTTCTG	TTCTGGCACAAAATAGCTTTCATTTCA
GGTTCTCTCTTCTGGTGAGATCCTTTT	TACTATCAGGTATAGGATGTTTTGGGGG
CTTATACTCAATTCTCAACTCCTTGTTTT	TCCCCTTCCAACTAAATTTTCAGCTTT
TGGGAAGGTTAGAAACACTACCTAAAA	AAGAAGAACATATGCGGCCTTTCAATG
ACAAGCTATGTCTTGACCTAGAGCAGG	TGTGAAGAGAACATGATTGGCAATACT
TTGAAAATTCTAATGACTTTGCATTTTTGA	GGTCATGAATAGTGCTTTTTACTTTGC
AGTGCTAAATGTGAACTGCTAATTTTT	CTTTTTGGTTGAGAAGGAGAGTTTGCC
AAGCCTCATAATTACTCTGTTATTTTTCTT	AGAGAGATGGCAAGTTTGGTTTTTCCC
AGGCTGTCTAGGTCAGTAATGATAGTT	TGGCTATTTAGACTGATTTTCCTGCTG
TGGCATCTGTATATTTATTTTAAACACTGC	ACGTCTCCGCAGTCTATATCTATAACTG
GGAATACCTTCAGGTCCTCTTCTAAAGC	GTCGTAAGCAAAGCCAGGAAAAACAAC
ACAACAGAAACTACCTGCTGCCACCTT	TATAAAATGTCACGTAAGGCTGTCGCG
CCACTTCACCCCGTCACCACCACTTT	ATTCATATCCGGACCCGCTGGGAACT
GGTCTCATTTTAAAAGCAACAAACCCC	ATAGACTGGACAATGGCTTCACACTCC
TTTAAAACAACTTCATTTGTGTTTTCTCC	TTTGGAAGAGTGTATTTCTGGATTTAGC
CCTTCAGAGTTCCTTCAGTTACAGGAT	ATTCTAACGTGAGGTGTGGCTCATTGG
GACCATCACATGCTAATAGTGTATTTTT	AATATGGGGAAGCCTTGGGCAGGTATT
GTGCAAATAACTAGCTTTTCTCTGGCT	TTGCTTGAATAGATGGGTACATCTGTT
GGTAGAGTGATTAAAAACATGTTATTTTCC	TTGCCTTCTGTACTATAGCATATCTGT
GCAATATCATCCCACATAAGATGTTGT	AGAAAAGTGATTACCTTGCTTGAAACC
CATGCTTATCTCCAACTCCTACTTTAG	GCTTCATTTTAGTGGTAAGTTCTAGGA
TCCGCTTATGGGATAACTCTACATGAC	GTGAACAAGTACACAGAGAGTGAATGA
TTTTCTGTCTTTACTTGTTCCTTTATTCTC	GCTTTGACATCCTTGGAAACAGTCAC
CCAATAACACAGTCCATGCAAGTGTTTTT	TCTCTCTCTCATAGGAGCCAGGAGAGA
GTTTATTGTGCTATTTTGTACTTAATGCT	ACAGAACTAGCTCAAAGGTATGTCCT
GCCCATGAGACACTCGTTTGCTAATA	ACTGGTCCAGCCACTTGCACGTTG
CCAAGAGCTCTTGTTGTCTTTGGGT	AAGAAGTCTTCTCTAAAGAAGCTGTCT
GTTCCTGAATTCATTCCGAGATTCAGT	GAGTGCATTCATTTTGGGTATCAGTGT
TACTAGCCTCAAACATATCTTCTTTGCC	TAGTACTCTTCCATCTTTTCTTGTTGC
CTCATCAACCATCTCATGATTATCTTTAA	TGAAGTAAGTTAGCCCTTATGTCTTAC
GGAGTTATATTTCCTTTCCTTGCAGAG	ATTTGAAGTGAATACACAGAGCGTGGC
TCCTACAGAAAAATGTTCTGGCAAAAC	TGTCACAATTTCTGTGTTTGTTAACCA
AAGTCACACTTGTGATTTGTTAAATTTTT	ATTTTCCAACTAATGGAGGCAAGCAGC
GTTGTTAGGAAATAGGACAGCCACTTG	AGGCCAACACTAAGAAGTTGCTTGGT
ACTGTTTCAAGGTCCCATTCTCATTTC	AGAAGGTTGCCCCATGTCCAGGCTCAT
AATGAACTTGCATATTCTTAACTTTTGTTT	CCAGCCATTTCTTAGAATCTTTAGAGTG
TGATCACGTTAATTCCCTATCTTGCTGC	TATTCCAGTCTACTTTTAGGAGGCCCT
ACACTGGCCTCTGCTAAGTATTCATAA	AAATTTGAGGGTGGGGGACTCAAAA
CCACAGATGAGTTTGATCAACGAATTC	GCTTTGAGACAGTAGGTTTAATGAGGG
CCTCTAAAATGTTCCTCTGTTGACTTT	GATGGTTGATGAACTTGCTAACATGCG
TACCTTGCTTGTTATAAGAGTAAAATTTGA	TTTTTCCAGGAGGCAGCATGGTGTT
TTTTTGGCTTCAGATGGGGATTTACTT	CCTTTCTAATTCCATGACCTCACTTGC
AGTCAAGTCAGTTACAAGGTAAAGAAG	TAAGGTTGGCAGTGATACTAAGCTGGC
ATCTTATGAACATCACTTACTTGCTTTTT	GCCACCACTTTATAAGGTCTTGGTACT
GAAGTAACTGGCTGTTCTCTTTTTCTCC	CTTAACATGGGCTCTTCACTAGTGACC
ACCTTCATTACTAATTCTCCCTTGTCTACC	TCTATAAATATTAGAACCAGCCGGGCG
GCAGTGGCGTGATCTCCGAAGC	GGGCCTTGTGGGCGGTGACTCAGCAT
GTCTCGGATTCCCAGACATTACCATT	CGGGACCGAGACTTCGAGCGGCTGTA
AAATGGCGTCTGGCGGCGAGATAATGG	ACTCGTTCTCGATCTCGGTCGACCT
CACGTGCTTCGCCGCGGACCTTTGTGA	CGTCGCGCTTGTCGTGAAAGCGAA
AAGCCGGCGCCAGTTCGCGGGGCTCCGG	TGAGGACGCTATGGATGCCATGGAC
CTTGTCCAAAAACCAAGTTCACCCTG	TCAGCCGCTTTAAGGCCCTGCAATTT
GGTTGTTTCTTTGCACCGGAAAGATAT	AATGACCCCACAGCTCCACCATATGAC
CTTATAGAGAAAACGAGTGTCTCTCTG	CAAAATCAAAAACCGATGGGAGATGGG
CAGGAGGGAAACCTGATACCATTTTCT	CATCAGCACAAGGACTAGGTAGAAAAA
CTAAACCCAGTGCTTTAGCTTGCTTTG	TTGTGGTATGGATGAAACGCCGGGATA
CCAAGAGAACTGAAATCTAAAAGACAAT	TCTGTGATTATGATGGGAACTTCATAG
TGCAGCATAGTTGTAATCCGCTTTATG	TCGGGTAATCCTCCCAAATCAAATATT
ACTGCACATATATTCAAATAATTAACCTGT	GTTCCACTCATAGGAGGAATTCCTGAA
AAGCAAGAAGGGGCTTTGTTCTGGAA	GGAACGCTGCAGATCTATTTACTTGAT
TACTGTCTTTCATCAACATACAAGAAAAA	TACAGGTTTAGTTCCAAATGCAACTGG
TACAAAAACACTACAAACAGCATTTCA	GCAACAGTAAGGACAAACATCCTATTTG
GACCATGCTAATGCATGTTTTCCAGAA	GCAGAAAATCAAGTGCCATTAGCCAAG
TTGGAGAGATCAGTGGCCCGAGGAACA	GGCATGGACCACTGAAGGACAACTT
AGTTGTGTGAGTGACAGGCTGTACT	GGCTCTTTATAATGCAAGGAGAGCATG
AAACACAAATAGAGTTTTTGGTTGGCT	AATGAATGGTTACCCTTCATTCCAGGG
ACTTTCCTCAAGTCATCTTCAAATTATTAT	TCATCATAAGGCTACAAAAATAGCAAG
CACAGAATTATCAGCTGGTTGGAATCT	AAATGAGCTCATTATCAGAGATGGGGC
ATGAAAACAGTTAAAATTGTGCCACCT	AATACCTGAAAGCATAGGAATCACAGT
CAGCCCTAAAGCCATATTCGGATACT	GGCTCACTGCTCTCATATTGTACTTTTC
CTACCATCTGGCATTTCATAGTATGAA	GCAGATTTTAAGGTGGATGAAGATGGC
TGTTATGGAATGAATAAGGCAATTTTTGT	TATAACTGGAATACTGACCGTCAGCAA
ACTGCATGTACAAATATATCTTTTGAGAT	GAAACATTCCACTTGGCATAAAGCCTC
GCCCCGCAGCGGCGCGGGGAACAAAG	CGCGGAGAAACGGCTCCAGGCAGTTT
CATGCCTAACTGTCTCTTTGCTTCTC	GAAACCTTAAGCAGCTCCCGGCAAAGA
AAACCATCTCCTGCCACCCATTTCT	CTGGACTCCATGACAATCTCTACAGTC
GTGGATTCCAACTCCAACGCGGACAGT	TAGCAAAGCCACGAAGGAGGAAGAAA
GTTTTGGGGGAAGTCAAAAGTTACACA	TTTTTCCAGCACGGGACACCTTCTGGT
GTCACTGAGAAAATTTCTTTATTCTTTTGC	AGCTAACTGACAATGACCTGGTGGCTT
AAAATCTAAGTCAGCCTCCTCATTTTC	GCACAAGAAGTATAACTTCGCATGGAT
GCATTGTGAAGCTGGATCTTTTTGGATT	CAGACTGCAGGTTCACTGTGAAAAG
CTAGACATTCTCTCTGGGTCTAAAAGA	CATGCTATACAGAGTATGGGCTCCAAG
GATGAAGGACCAGATACTTTGTCCTTA	GGTAAGAGAGCAAAGATCCATGGCATA
CCAAAGTTTCCACACAAAAAGTATGGA	TCCACTCGTAACAGTATCTTTCTTGCT
TTCATTTCGGTATTCATTTCCAACTTTCAG	ACCTTAAAACCAAAGCACCAGCA
TTTCTTACCCTGGGCCTTTGCAAAGGAAG	AAGTCCTGTGGGAGGCCCGTGTCATA
CAAGATCCCCGCTCTTGAGCCC	GGATCAAGATGGAGGAGGTACAAAGGA
TGATGCCTCTTGGGCACTATCTG	AAGGGCTGAAGCCCGTTGCACTCAG
ATACAGAAGGGAAAAGGGAAGGTTATTCC	AGATCATGCCAGAGAAAGCCTTGGCTT
TAGACACACCTCCTGGGATAACTTTCTC	TTCCACCACCGCTTTAATGGACTGTCT
AGTTGGCCTTGAAACTGGTGGAAATG	TCGAGAGGCAGTTATGGCCACCTCTGATAA
TGGTGGAAGTTCCCTCATGAATCGTC	GTGCTAGGTTTTGGTTTGCTGCAAGT
CAAAGAAGCAGCCTTTGCTCACAGT	GCGTGTTGGATAAGAAGACCATCAAAAC
GGTTCCCCTCTTGCTGACATTAATCT	GCTTTCCAACTTTCTTGTGAAATTTCATC
GGGGCAGCAGCCATTGAAAGCAAACT	ACTTGTGGCGTCTTCACCAGCAGCTAT
ATCAGTCTGGGTGGAGACAGCTTCCA	ACTGAAAGTTGGAAGGCACGGCTGGAA
AACCCAAAAGGGAATACACAGTGGAAC	TCTTTTGATTTCTGCTCCCTGGACAAC
GAGATTCTGAACACTTGGAACTTGGTG	TACCTCCTTCGGGATTCTGAGCTCTTC
CTGAAAGCTTTGGGGTTGTTATTTTT	CTTTGGGTTCACCCCAAGCAAGATGAA
TCTTATCTCTTCCCCTCCCGCAGT	GAAGAGGCGCGGGCGTCCCAGGAA
TCCCGGGCCATGTGGATGACCGC	TCACGAAGTTGTTGCCTGTTTTTGATT
GACACCATCATGGCCACCATCGA	GCAGAGGAAGTCCCGAGGGAGTGAGA
TTCTGAAGGTGTCTCCCTGCTTTGCTT	TTTTGGCTTTCACCTCCTCTTCCTGGG
AGGCCCTGAGGTGTGTGCTCTG	GCCTGCCTCCAGGGCTGGACTGA
GTGAGGGCTGAAGGAGAATCAAAGATA	TCTCTACAGCTCGTCCTTGGCCTGGCC
AACGCTGGGGACGTCACGTGAACG	GCGTAGGGCCCTGTGCAGCTTT
GTGCCCCTCCTCTCACCCTTGC	TGGGTGGCCTGTGTGTGTCTGTGTCT
CCATACCTTTCCCTCCCACCCC	CTTCCCTGGAGAGAGTGGAGCTTACAT
CCTGCCCCGCTCTCCCCTCCCACCTC	TTGGAGGGGGTCAAAGACACAGGTAGA
GGTTTTATCCGGCTTTTATTCCCTTTG	TTCCTCCCCTTCCCTCCATTCCCTTT
CAAACCCCTCTGTGTCTCCCTCTCTCA	GAGTGAGGTCCAGGAAACGTGTGTGAT
TCCCTCACCACTCCTTTCTCTTTCAT	AGCTGGAGTGGCTTAGGAAGTTGTGTA
AATTGAAGTCCTCCTCTTCTCTACCCA	CTGCTGACATCCTTTGGGCCCCTCAA
ACACACAGGGCACTGCCTCAGGTTG	TCTTTGACCTGCAGTAGCCGAGAGTCC
TTAATCCCCTTTGCCTTCCCCTCTT	GGACCCTGGGGGTGGGAGGGGCTGGCTA
GTGACGCCGCTGCCTCCCCTGG	AAGTCCATCGAGATCCCCCGGCCTGT
CACTCAGTGATGGCATACACCTATACG	ACAAGCCCGTACTTGCTGCACTCGTCC
CACAAACCTGCCTCTCCTTTCCC	CTCTGAAGACGATGGGCAGAGGAGTGA
TGACCCAGCTCGGGGGCTCGGAGCT	TCGCCTCCCGGCCGGCGACTGAGG
GTCGCCCAGCCGTGGCTTCGCGGAGCA	TGCAGCACGGCCGCGGGCCGCCAA
GCTGGCTCGCGCTTGTTCACGG	TTCTCGCTCACGGCGCGCTCCAGCTT
GTGGATCCCGCCGTGGTCTTCCCCTTT	CCTGAGCGATTCAGGTAAAGACCGAA
GGAAGGAACTTTAGTGAAGGCGAGAAT	TGTCCTCTCCGGAGGTACTGAGGGC
TCACATGAGAGTAACTAGCATCTTTCTCTC	CCTTCCCATCCACCAGCAGCACAACTAT
AAGGTCGTTGCGGCGCTGGCGCTCCAG	ATCGTTTGAGGATCAGCTCGCTGGA
CAGTGAGCGTCGCAGAAACCACAACAT	CAGCAGCAGTTGCTAAAGAAAATTGAAC
ATCCTGGGATGCAGGCTCTCCAAGGTC	CTTGCCTGCAATTTTTCCTTTTCCAGC
CTCCTCCGAGCTCCCAGCAGGGACACT	CTGGAGGGGACCAGATACAGTGATAAA
GTGGAGCTGCCGCCGCCGCCGGGGAGAA	GGCCATCTTCCTTTAAGAACGGGACA
TAGCAGACATAAGGTAAAAATGGCATGG	GCACAGAACCACACCCACTCTCTCAA
GCCACTGAGCTTAACAACGGGCACA	ATACTGACGGCAGCAGGCTTCTCTGAA
TTCCACCTTACTATACCTGAGTGTGTA	AGATGGGGTGAGTGAGGAGTGGCCAGT
CGGCCACGCCGCCGTCTCGCCCTGGCTCCT	ACAGATACAGAAGATCAACAGGTCTATCAG
GCTCTGCCAGGCTTTTCTCTAGATAAT	TGGAAGGATTTAAAATGTTTCTCTGCT
ACCGGGGAAGGAACTTGTATGAACTT	CAAGTTATTTTCTGGAGAAGCAGAGGC
CTGTTTGCAACAGCTCTATGTCAGCA	CTACTGGCTGCTGTGCATATATTAGAC
ACAAATGGAAAATACAACTACGAGAGA	ATGAGAGCTGATTATTTTGCTGGGAAG
CTGCGCCCCGATCGCGCCCAAC	ACGCATGCGCGTAGGGAGCACGTAGT
CAGGGACTTGACAGCAGGTTCCTCTT	TTTGCGCTCTGGACTTAGCAAATACAG
GGACAGGTCTGTGGACAAACTGACT	GCAGTACCCATACCTGGTCCGTGAGT
ATTGTCTGGACAGGCCTAGGGATAGCA	AGAAACTGGCATCAGGTGCATGGGAAC
ACTTCAGCAGCATTCTGGGATTACA	GCTGATGAGAAGTTGAGAGGGAAGGTT
GGCCTGGAAAATGATGCAAGAGATAC	GAAAGAGACCCACAGATTACAGGAAGC
AAAAGTCAGTTCCAGGGTAGATGCTG	GCCTGGGCAGCCTGCTGGGTCC
TTGGCTGAGCGGCGTACTGACATCTT	AACATCACCCTCCAGGAGCAGATTGAG
CTTACCAATGGCTGTTTCCTCTACACC	ATCTAAGCCTATAAACCCAGTGCTTGG
ATGGGCTCTCCTGGAACCCCCA	AGATGTTTCAGTAAGAACACTGGTGGG
CCCGAGGGTTGGGAAGCAGGCCCT	TCTGCCAGCCAGCGTCCATGTGCTAA
CTTTGATAAGGAATACCTTTGCCTCTGG	GCCTGCAGGATGACCTTTTCCC
TCCCCATCTGGAGTCACTCCTCACAGA	CCACCTCCAGGGCTTTCATCAAAGTCA
ACTGGTTGCAAGAAATGCTATTCAGTT	GACTTAGGGCAAGTTACTTAACCTCAG
ACCCCAGCCCCATCCTGCCCAG	GGGCACGATGGTCTCTTGGATTACTT
GGGAAGTCAATGCTCTTGTGATTTAGA	AAGAGCCTCCTCCTGAGTTTGAGTTCA
CGTAAGTGAAGGGGGCACTGGG	CGTTCTGTCGGATCCTAGCTTCAAAT
TTCAAGCTGAATGAGGCAGATGGCACT	GATCAACAACCCCAAGTTCAACTTTCT
AAACCCACCTCTGACCCACCCAAGTA	GGTTCTCCACTGTAAAACTCCTCTAGG
CGGCTGCAGGCTGAGGGGCGGGGGAGA	GCCGCGAAGGTACGACTGGCGCACTT
CCCTTTCTTGCTCTTCTTGGACTTGT	CTTCATAGTCCCATCACCAGATGGCTA
GAGGTCCCCTGGGAGGGGCGGGGT	CCCCCAGTCCCCACCAGCTCAGTCAA
GCCCCCTCCCAGCCACCTGTGC	GGGGGCCTGCTTAACCGGCAAGTTCT
TAGTCGGTCCATGGCTTCCAACTAGTA	CAAGAGAACAACCATGAGCTCAAACTG
CCCTCTTTGGAAACACTTTACTATACT	CAATCAGAGGAGGGACTTAGCTTCAAC
AGCACTTGACCATTTAAATAATGAAGAC	TATAAGTAAGGAAATACTCCCCCAGCC
ACTCATAAAAGGAAAAATGAAACAGAAGT	ATGGACAGTCTAAAACATGAGTGATAT
GCCAACCCATTTCTCCCTACTAAGCAA	AAAGGTTTCTTACCGTATGTCCTTGGA
CAATGGTTCAAAGCTAAAACTCTTGGA	TTCCACATTAAAGTGGTCATGATTAAC
TCCAGCTTTCACGTAAATTATAAGAAATT	ACTTTATCCCAAATAGTACCACAAGGC
TTGCCTTTACAGAACTTAATGAGCTTT	CATAGGAACCAGTTGCTAGAAGTGTACC
CCCATACAACATTAGTGTCACACAGTG	TGGGTTTGCCAGAATATGGACTAAAGA
GGCTCTGAGGGTTAGGTATACTAGTAA	CATTCTCACGTATCAGAACAAGGCAAC
AAGTCATTTTAGTATCACTTTGAGAAACA	TAGGCAGTATTACAACATGGTGGATGG
TGCACATGTACCCCGAATTAAAAGTTT	GTTGTCTTGTTTGTACTACATCAGGCA
TCCCTCCGGACTTCTTATATGAATTCA	AGCTTATAGAGATAAGCTTGCACAGCA
GACAGCTGACTTAACGGCATATTTAAG	CTAGTGGCAACATGCTAAATGACACAG
GCAGTCCAGACATTAAGAAAACATACA	TGAGGTCACAACACAGGATATAACCC
GCTCGGATCCCATCGCAGCTAC	GAGACTCCAGGTGGCCCTCGGACTCT
TACTCAACACGATTCTGTTTTTCTTGGC	TGAATGGATCACGGAAAAGGCAGAAG
CAGTGAAGAAACATGTGTTTTAGGCCT	TCTGCTTATTCTCATTCGTTTCATCCA
TCCAACTACTGATTTTGGATATGCTTC	CTACCATCGGCTCTGTCTGCATTGTT
GAACTATGAACAGCTAGCTCCCTGATT	CGCGTTTCACACTTTTGATCATGATGC
TTTGAGGGGCCACATTTCTTTTCATTC	CTCTTTCAGAAGAGTCTGTCCTGAAAC
GTTAATATGGAGAAGTTAATTGCTGCT	GTGTTCATGTGTTATGCCAATAATACT
GCTTTCATTGCAAGAGGCTACAAGGAT	CCAGAATCATTAACTCTCGCTGAACTG
ATGGTTTCTTTCTGTCTTATTTCATTCTAA	GGGGATTACACATTACCCCCTTTTCCA
GGTGATTGACTAGTTGTCTTTTCTTTG	TTGTAACAGCTGCAAGGACTCAACTTG
GCCAGGGCTTTTGTTTTCTTCCCTTT	GGGGATGTTTAGGCTCTGTCTACCATA
TTGTGATTCCACATTTCTCTTCCATTG	GTGGAAGGTTGTTGAGGAGATAAATGG
CTTCTTTCTAACCTTTTCTTATGTGCTT	TTCATGGGGTCATAAGGGTTTGCAATC
TTCAGTCATGACTTGTTTCATCTCTCCC	ATGCAGACCAGTTCTGCTTTATGGTAG
TTGCTAAGAAAAATCCTCTCTTCCTCAC	GAGAACAGAGCATTTTAGAGCCATAGT
TAACATTATTGACTCTGTTGTGCTTCT	GATTAACACTGCTTTGCAAACTGTGTC
GTGTTATGAAAACCCTCAACATCTGGG	CAAGGAAGCAGGACACCAATGAAACTT
GAGGGATAGTAAATGGCCCTTGTCTTG	CTCCTAATCTTAGGTTGCAAATTGGGC
CTGTATTGACTATGGGCTTGTTTTCTCC	TTCAACTTGCATCCAACTCCAGGATAG
TGCCCTTTAGACAGAATTTATTTCTTTTTC	TTTTGTTGGCCTAGTAGTGCATTTCCC
CTAAGAATGTAACTGCACTCTACTCTC	GAATGGTGGTAGAGTTTTTGTTCCCTC
TGCTCACCACAATCTATTCTTGCTTTC	CGAATTTAGTGCCCAGTATCCCTATCT
TCACTTCATCTATCAATGTTCTCTGATTTC	TTTGATTCATCCTGTAACTAGGGTCCC
GGGGAGAGTGGTACTCCCTGTCGTCAA	GGACCAGAAACTGTCAGTCCAGATC
ATGGGCATCCTCTGTCCTATCTCCCA	TCCCACCCTCAGGACTATACCAATCTG
TCCTTTTCCCTCCCTGGGATCCCTT	TTTAAAGGGTCCCACTTGACAACACTG
TCTGCCTGGAGTGGGCCCAGTG	GGAGTCATTCATGATGTCCCTAGCCA
GTGGTAAAGGACCAAAACTGTTGTTCA	ACTACATTGTCAAGGGCAATGTAAGTG
TCTGAGCAAGGTGAGGAGGTCCCAGGG	AACCTGGCCCTGGCTCATAGCCACCCA
CTTGTTATCAAGCAAATGGGGCCTG	CAACTGGAACCTCCCTTTCTGATAAGA
GCCTTTTTCTTGTCCTTTGCCAGG	CTCCCCTCCATGAACAGGAGCATGAGA
CCTTGGCCCCAGGAACCCCAAG	AGATACATGGGGACCAAATGCAGAGA
TCCCTTCCCTCATCCCCTCCCCTCACT	AGCTGCCATCTCACCAAACTGCA
TCAGAAACAAGGTCCAGGAACTGCCTG	ATCACTCCACAGCTTCCTATCACAGGG
ACCTGGCAGCCCCACTCCGCTC	GGGTGCTCAATAAATGCTTGTTGACTG
GGCGGTGCGGGTGCGAAGGCTCCCTCT	CTTCAGGGTTCCCAGCGCCAGCATGT
AGCGTCATATGGACATTCATCAACGG	TCTGAGCCACATTCTGCTTTTGCCAGG
AGGCAGCACACAAAAGGGTGCCAGA	AGCTCTCCAGCCTCCTGGGTTTCT
CGTTGGGCCCTGAATATTTTACCAAAA	TGACGTTTGAGCTCACCCTTCGATGTG
GGGCTGTGTAGACGGGAGCTGATAAGT	AGAACACACAAGCATCTGGCATTAGTG
TAAGGGAAAGCTCCTGGAGAGTGG	TTGCCGGCATGTTGGAAATCTACTTG
GCCAGTATTAGCCCCATTTTACAAGTG	TACTCCTGCGTGGCCAGCAACGTGCAG
GACTTCACCTTGTGATCTGCAGGGACT	GCTCCCTGAACATGATAGAGATATTGC
TGGCTGCCGGTCCCCATGCCCCA	CAGCACCGGGTCTGTGAGCAGACA
CTCAGATGAATGATCAGCCTCTCTGAG	AAGCAGGCGTCTCGCTGGTGCGTGTGC
AGGCCTCTTGGGAGGAGGCTCAGACT	GCAAGGTCACCGTTGCTCCTGGCTTCA
TTGAGGGTTAGGAGCTGAGCAAATGA	ATGTGTGGGCAATGGCAGCGTGGAATG
CCCAACAAAGTCCCCCACCCCC	CTGTTTGTCTTGTTTTCCTCTTCCTCC
TCAATTCCTCAAAAACATGTCAGTGTG	AAAATACTCAAAATTGGCTGGGTGCGG
GCGATCACCTGGATTGATGGCAACTAA	GAGCTGTCCATCCCCTCATGGTTTTA
CACCAACTACACTGTGTCCCCGGTCT	TCTGAAAAACTGACTTATATGAATTCAGG
AGTGTGAACATATGGCACCTTTGGAC	AAACAAGCTGATAAGTCGATGATGGGG
ATTTTATGTATGCTAAATTGGATGGCAA	AATAGGTACCTAAGCTTACCACTGAGC
GTGTGGGATTGTTAAAATATTCTTGCC	CTAGACAGTTTCCCTCTATCAAGATTG
AGGTGCCTTAAGTCCTTTTAGGAACAA	ATCAAACCATATGAGTCTGCTATTCCT
AAAATTGCAGGGCATGGAAATTTAGCT	ACTGCATCCCCTATATTGTAATGTGCT
ACCTACGTAACAAACCTCCATGTTCAG	AATTTCACTGAGTGTACCTCCTGTTAAG
ACCAAAGTCTCAGCATTTTTGTGCATT	GCAAACTCTCGAACAAGTTTAATAGTG
AGGAGTATTCTAACAAAACAGTGACTT	TATCCAAATCGCCCTCATGTGGAACT
TTGTTCTGCAAAGTGAATTATCTCCAT	AATTTTTCAGGATGGTGCAACTAAAAC
ACACACAAATAATATGAAAACGTTTGTTT	TATTTATGACATGCATCCTCCTGAACC
GCCCATCTCAAAAATGATACATAGTCT	CCACATTCATGATTTAGAAGGCTCAAT
GCAAGAACTAAACTGTCAATGTTAAAGA	GCATTCTTCAGTAAAGGATCTATTGCT
CGGCTTAATCGATACCTTATTTACATTTTC	AGATCATTTGTTATTTAGAAAGTGGGGA
AGACTGTATCACCTATACATGTAACCA	GTGCCATCCCATACCTGCCATAAGAGA
CTTATGGCAGTGTGACTCTTTTTCTCC	AGGACACCATTTCCATCTTGGAGAGTC
TGGTGCTAACTTATAATTCCCAGTATT	GTTAAAATACTTGCTTGAAGTGCGAGG
GCCCTCTCTTAATTATGCTGGCAAAAT	TCACTACTGAGGACCACAAAATGGTAG
TCTTATCTCCTGAAAAGCTTGCTGTCA	GTTAGTTTTACATTTGTCTGGTCCACA
TTTTGCAGTGTGTATTGAAAGCCAAGA	TGCCTGCTCTTTAGTGGAAACTATGAA
ATCAATAATGCATTTCCACTCCAAAAA	TCATATTAGCAGCAAATCCATGTAACT
GCATATACAGGTATAGGTGTAATACTCTAA	AGTGAAATGTGCAAAGTTGTCTAAGCT
GCTCTTTTAACAACATTTTTATCGGATATC	GTAAGCACTGGTCAAGAAATGATTGGA
AGTAAAACCCAGTTATTAGACGTGTCT	CGCTCAGCGGTGAGAGCAGCAGCAAA
TCAGACTATCAAAAGCATATCAAAACAAG	ATAAAGACCCCACCAAAACGTCCAGGA
CCTCTGCAATAATTAGGCACTAAGTCT	CTTCATACAACTTTCCTTCAGGCTCTT
ATCAAACACTAGCTATAATGCTTCTAGCTC	TTTAGCAAGAGCACGCTGAAATAAAACC
CTAACGAGCAAGAATTCACTGATTGCC	CTGGAGCTGAATCTATCAGTTTGCTTG
TTTTCCTCTGAGACAACAGCGGCAAT	CTGTACTTAATGCTGCTGAGCAATCAC
GGTTTTTGCTAAATCTGGAATGAAAATT	ATTTTAAATATGAAAATACACAGTGGCTGA
AAATGACTTAATGGATAGATTTGCTTACTT	ACATAGGTCATACAGTTTTGAACAGTA
TCATCAAGGAACTATTCCAACAGAACA	TCACCACTGATTTCTATCTTCCAAAGG
AAAAAGAAAATGTGCCATACAGTTGCA	TCAATTTCTTGGTGGGCGGTGCCAGAT
GAAAAGCAGGGGAATATAGTCAGTCCA	GATGTGGAAAGAGACAGGAGGAGTAGA
TGCTGTATAAATCTAAAGGTTCATATGCT	AACATATATCCCACAAATGGGGAGGAG
ATCCCCAGAATCACTGAACATGAAATGC	ACCACAACAGCCAATCAATGGAAAAAC
TATGCTGGAATAACCATCATTCCCACA	CTTCTCTCATTATCTCACGATCATCCA
GCCCCAGTGTTGTAACTGTGTGTAATT	CAGTGCTTTTGAGGATGACGACATGTT
TTTTCTTGATGAAAATGCATTACATGAAA	GGGCCACATCGATGTCACTTTAAAAG
TTCCAAATCACTTACATTCTTGGATTG	GCAGTTCAGCTTGAATCAGAGTAGAGT
TTATTGCAGACCAAGTCAACAATTTTT	AGAGGGAGATAAGTAGGTATAACTTCC
CAACAACAAAAACCAAACAAGTTTAACA	CGTGCCATTCATAGTCTTCTTTTTATC
ACAAAGTGAATAAAAATGTCAACATCAAAC	ACAGAAGAAAACCTAAGAGGGGAAAAA
ACTTTCAGCTCTTAGTATTTTGGGGTC	TTCATAGCCAGCCAGAACAATGTTC
AGGCTCTCCTTGCAGCTGCTTAGA	ATCGGGGTAAAGTGACTTGTCAAGATG
CTAGGGGACAGGGGCGGGGTGG	AGCGGGGCACACAAAGCGGGAG
GATATCTGGAAGAAATTCGAGCTGCTG	ATCATCATCCAGGACTGTATGTGGAG
TTGGGCGAGCTGCTGTCGTTGAGAGG	TTTTTGATGAAGGTCTCGTCGTCCGGG
TCGACCCCTCGGTGGTCTTCCCCTA	GGATACCTTTCCCATTTTCATTGGCAG
GCTAAAGGAGTGATTTCTATTTCCTTTC	CTGCCAAGAGGGTCAAGTTGGACAGT
TAAGGATAACTACCTTGGGGGCCTTTTC	AGGATAGTCCTTCCGAGTGGAGGGA
TGACCAGATCCCGGAGTTGGAAAACAA	CTAACAGAAATGTCCTGAGCAATCACC
TTCATACTTTCAGTGTATTTTGAAGTGAT	CTTGATTTACATTCATGTGACATTGGA
GGGTACAAATTCTCAGATCATCAGTCC	GAAGCCCTCCCGGGCAGCGTCGTGCA
TAGGGGTAATTAGACACCTGGGGCTTG	TGGACACGCTGGTGGTGCTGCACCGGG
GCAGGACTCCTTCAGTTCTTCACTAGT	CACGTCCATTACAATTAGAAGAGTTCA
ATAAGCTAACACAAAGCTAAACTTAAACTG	CATTTACTACCTGTATTTTCAAGGAGC
AGTGATAAAATGTTCCTGGTAGTATTAAAG	TTTGCCGTTGTAATTACTACCGGTACT
TGATATACACACGAACAACTATGATACTC	TCGAGGGGAACAAAGCTCAATAAAGTC
GACAACCCTCACATACCCAACACACT	CAGGTTAATAATTCATAGATGGGGGAAG
CCATGCCTCCATCTAGAAGAGATTATGAT	AAGAGGCTGCACTTAGTGGTAGACAAG
GAGGTGGTCCTCGACGAGGGCTCATAT	ACAGAGATGGAACAAACTTACAGACTG
ATCAAATGTAAACAAAAAGTGTTCTGAAG	GCTTTCCTAGGTTCAGTGAAAATTGCA
CCAGCAAAGAATACGGCAGAATT	AATATACTGTTGCAGTGAGCAACCTGA
AGTGGGGTTCAATGGCACTATGACAT	GAAACTGCTTTATTCAACATTAAGACGA
CCCCATCATACCCCAATACAACATACT	CAAACTTTCACAGAGATGTAACACATG
CAGTGAGGCATAAACTGTTGGGACAT	GGTAAGTCGATCCAGTACATGGGCAA
TGCTCGTGTAGTAGTTTAAACTCTTAA	CTATTTGGGGTTGTAAAAACGACCAGG
ACCACCTTCAAATTTTCAAGAATAAAATTT	GGCATTGCTACAGACTTGAACGTTATG
CAAAAATTCACCACACACTCCTAAGGC	GCAGCTAGTACATTTGGCTTATTGGAA
ATTTGTTGGAAGATGAAGAAGCTAAGA	TTTGGGTAACATTGCAATTACATGAAA
ATAATAGGTACCCCTTTCCAGAAGAGG	GTTTCTTGATTTGTTTTAAACGGGCTG
TCGCTGACCGTTCTGGAAGATCTTGAA	CTCATGCATTCATCTTAGGCCTTCAAG
GTTCCGGCCCCCGACGTGCTGG	TTTTCTTTCTTCCCTCTTCTCTTCTCTTC
TCCCAATTTTCTCTTCCTTTTTCTTTTT	TAGTGGTGGTTGCAGGAGATAGAAATC
TGATATGTCTGATTTGGTTCCTTTCTTCTC	GCAGCTTCTTGGTGCGTGAGAGTGAGA
CATCTTCTTGGTTGAGCTTTCTTGCAA	ATTGATCCCGCTGCTCAGCAGATACTC
GGGCTGAAGGCTGTTCCCTGTTTCCTT	CTGGGCGGGGGCCAGTACGGGGAGGTGTA
AGACACAGGAATGATATAAGACGGAAA	TTGTGCTTCATGGTGATGTCCGTGCGT
TTCCTGAAATAATTTCACCTTCGTTTT	AACCTCGTTGGAATATTTGTGCTCTGC
GTTGAAGTCCTCGTTGTCTTGTTGG	CCAGGCAGCCTGCGCCATGGAGTCACA
CTCTCATGGGTGAACATTTTCCTTTCT	TCCTTCCTGACTACAGGAGGGTTTTT
AACAGCCTTTCTCTTTCGGTTTTCTTTC	GAAATTCAACTGTGCAGGAGTGTGTAC
TGATCTGACTTGGGTTTCATCTGTCC	CAGAGGTGTGGAGTATTGTGCTTTCT
TTTTTGTTTCTGTCCCTGTATGATTCT	CCAGAGGCTACATTCAGGCCATCATA
CTGGAGTGCAGCAGTGGCACTCT	CCAAAGACAAAAAGACCAACTTGTTCAG
ACTTGGCTGGGTCAGCTGTGTCCAAGG	AGAAGGCGCTCATCTTCATTCAGGCC
GCAACGGGGCACTGGCTTTCAC	GCTCCAGCAAGCGCTTCCTGCGCTCTT
TCTTCCGAGGCAGAGCCGGCTTCTCA	TAGGCGGCTGCTGGTCAGCGTGCTGG
ACTCGTCCACATTTGGAGGGCACAAAA	CTCCAAAACCCCTCCGGCGGCAGGTCA
TTGTGCCTCCTCACTCTGGACTCCTC	AGGTTGGGCGGGCTGGAGCCCGGGCTGG
CACCAGCAAAGCAGGCTCAGGT	CCAGGAGGCGGCCGGGGAGGCAGTCCT
ATGGGGGTCCCCGACGGCTTGGCGGAC	TTCCCTGCAGAGGCTGCTGGTGGGGG
GCCCAGCCAGCCGGGAGAGGGCCTCAAAAA	AAACCCGCCAGCCTCCAGAGCGGAT
ATGGAATCCACATAGCTCACGCAGAAC	ATATGAGAGGGATGAAGGCGGTGGAAG
TGCTGGAGGCCGGCAAAAACCTCTACA	AGTGACATAGTGCAGAGGTAGCAGCA
TGCAAACGTAGGTAGTAGAGCTGGACT	ATTTCCTTCACCGAACTGAGGAGCTTG
AAGGCCAGCCGGCCGCCCCCACCCA	GGACTTCTTCCTCCGTGCCTTGA
ACAGGAGCGCATGCATCACGACATC	AGGACGGCAAGGGCTGCCTGCTG
AGGTTGTACTCGTCCAGCAGCCTCA	CCATCACCAGAGGAAGCAGCAGTACAA
AGAGCCTGTTCCCGGGATGGGG	CCAGGGATGCTGCCGCAGGACACTGA
TGACCGTGGGCGCCGGGTCTCACTCA	GTGTGCGTCACGCTTGAAGACCACGTT
TACTGCAAGGACCACTTCAGCGACGGG	GCCAGCAGATGATCTTCCCCTACTA
GCGCTGTTGCAGCCCTGGTCGCAGT	CCCAAGCCAGGCCACATCCAAGTTCA
GCCAGACCTGGAGGGGCGGGGCGGT	TCAGGCAAGCGAGGAGAGGATCAGGTT
CTGATCGTCGTGTATATGTCTTAATCTTCC	GACTTCTGCCCCCAAGTAGTTATTTAG
TGCAGCACTCAGTTTAATAAAACATTT	TTCTGTATAAAATCTTGTACCAAATAGGTC
TGCCCATTTCTTTTATCTGATTACATCA	CTCTCATGAAGAGTTGCCTATCTTGGG
GAAACAAAGTTACTTTTTCTTCCCCTT	AGTTTAGACATAACACCAGAGTTCCCT
TTTATTAGTCCTGTGTTTGCACCATTT	TACAAATGGTATTCATGACCCCTGTGG
TCCACCAGTAAAGTCATGGTTATTTTC	TTCAAATGTCCGTCATCAGACATCTGC
CTAGTGAATTTAAGCTTTTCTTTCATACGC	AAGAACGTGGGGAAAGTGATTCAGTTC
GTATTGACGTGACATTGGCAACAAGGT	AACTCGGGCAACACATCCTCATAGAAG
TAACTACTTTGGGGAATGTTAGCCTGG	CTGTTGATGTCTGGGATTTTTCCACTG
CTGTAAAGCATATCATTTGATTTTTGGTT	GAAACCCAGTATTTTCAAGTGGTGAGG
GTGCTGTTTCATCACTGTGCCATTG	CAGACCACTCCTACAAAAGAAATGGGG
TCCTCCTGCCACGACTTCGGGAC	ACTAGGGTTTCTCCTTCCCCGCAGC
GCCGCAGCCGGAGCCAAAGTTCCTCTA	CCTGTGTAGCCTGGAATTCTATTTAAA
TTCACCAGTCCTCTTCTGCTTAAATCA	AAATAAGATGGTAGGCTGCCTTTTGTC
CACACTGTACATGGTGGGTCCAGCTT	CGATAAAATTCTGCCTCTGCAATGGTG
CTGGTCCACTTGGGTTGGTAGTTAATA	CAGGTTTCTGCAAGTCTCTTGTTCTCT
AGCTAGTTTTCAATCACATGACAGCC	ATCAGTAAACTACAGCAAGATGTCCAC
TTGGGACTTCTATGGCAGCTCTGTTTG	CCTTCCTCTCTTATTTGCCCTCCATTA
GAACTAGAGCAAACAATGCAGCTTACC	TCATTTCCTGTCTTCCTCTTTCTCAGC
TGAATAAGACCATTTCTTGAACTTTGTC	CAGTTGTCTCCTTTAAAAGCAACAGGC
CAGGCTGAGAACAAGACACATCACT	AGATCACTGCACAATGACCTTGTAAGG
CAGCCCCAGGGAGCGCCCACAGGGACA	TGGGCTCCGGCCGCTTTCTGAATCT
CTAGTAAGAATGAAATCCCTTCCCCCA	TTCGGACTATGATCTGTCACCAGCCAA
CCCCAGAGGGAAGCCGGGGTCAAGA	TGGTTTTCTTTAATTTTCTGCTGTTTGGC
TCAGTGTTAACAATGGGCTTTTCTTCC	AAGACAGATGTGCTGTGTGCAGACGAA
GTGAACACTCAAGGGGTGGCCC	GTGCAGCAAGTGGCGTTGTTTTT
CCCATTAGTGATGCGTAAGACAGTTTG	TTAGAGAACGATGGGAGCAGCAGGTGT
CCCCCGGCAGGCGGGCGAAGCAGACA	TGTCCTCTGGGGCTTCAAAGGGATCA
CTCTGGAAAGTTCTGTTTCTGAGGGTT	AGATCTTCCTGTGGAGAAGTACTTTGT
CACAAGCAAACTGCTCAGGTTTACT	ATCATTGCACGCTAGAAAGAGAACGG
ACACATGACTTTATGAATAAAGAATGTGT	CGCTTCTCAGAGTTGGAGATGAAAGAA
ACACAATGAATAAAGACGACCATGGCC	TCTTAACATTGCAAAACAATTTGGCTT
ACCACAAGCTTCATTCACCAAATCTGC	CCCACGTAACCCGCTGAGTTGGCGATT
GCTGTAACTTTTGGTAAAACCCAAGAGGA	GATTCAAATGTGTCACTACCGAACTGTAT
GGGGGTCACATCCACACTTGGT	TTGAAAGTATAAGTTTCGTGGAAGTCACTG
AAACTGACACAAACGTGTCCAAACCCAGC	TGTTCTGGCAGGTACCAACAAAGAGA
GCTCAGCGCTCTGGCCAACACTCTCT	TAGTTTCCAAAATCTCGGAAAACCGAT
TTTGTGACCTACCAAGATGCCCTGGGG	ACCGACAAGAACCTAAAGCCGAACC
CCTCTTTAGTAATCTCTATGGGCGTGTG	CATGTAAGGAGAGGGGACTTACAGCAA
AAAGCCAGCAACCCAGAACCGAGTTT	TGTTACCCAATGGCAGTCTGTTTCCT
TGCCTCATTTGGAGACAGAAATATAGAGC	CTGCATTGGCATTGGGGGCGGGTGAT
GCAAAAGCATGTCGCTGAAAAACAAGG	AGAAACCACACCATCCGTTATTCAGC
GCCGCCCATGCGCGGGCATGATGAACT	TTCGGAATCTCACTTCCGGAGAGCACTAA
AAGCAGACCGTTACCAAAGACGTCACA	GTGCTATCTATAGATCTGAAATCATCAGC
ACATCCACCACTTTAGAAGACAAGTCT	CGGGGAACTCGCTGCTAACTGTCATGTAT
GACACAGCTCTCCTGTTGCCCC	AAGGCTCCGGAAGGGGGCGAAGGTG
GGTGTCTGCAGCAGGCTGGGTGGGAA	CTTTTGTCTGCGCAATGGACGAGA
TACAGCTTGGCCCAGCCGCTGTATTCT	CCTGGGAATCCTGTTGATTCCCA
GAAAGCGCTCCCCATTGGTGCAGACT	TCTGTTTGTCGCTGGCAGGCCTGT
GGCCTTGGGTTTTCTTCGGAAAGAAAT	CCCTCTCAACATCAATGGTGCTAGTTA
GTGTATTCGGTTTGAACTGCATCTCTG	TGTTACTGGGATACTCCTTCAAGGCA
TGGCATCAACAGAAGCTATTAATCTCT	AGCTGTCAATGGCCCATATTGAAAGTC
CTCAGGCCCGGCCCAGATGGGCGCATT	ATTCATAAAGGATGCAGATGGGGAAGG
AGGGATCCAGACAGGGCGGGAGGGCAAAAA	TGGTTCTCTCTGGGTGTGAGAGGATAT
GGACTGGCTCCTGAGCCAGGCC	GTGGGGAAAAGAGAGGTTGAGAGGAGA
CCAGGCCCCACTTTCTTTGCAC	GCCCCTGAAAGCCAAGACATCAACAAA
CTCTTCGTCAACTGCCCTAGGGGATCA	GGATGGAGATAGGGACAGGAAGCCTA
AGGCATTCGAACAGATCAAGAAGGAG	GTCTCAGATACAGATCCTGACCCATCT
CAAAACAAGCATTGAAGCGGTCAAAGC	TGGATACAATGCAGAGCAAGAAACAGG
CGTAGGCCCAAGTAGAAGGGTAAATCT	GAAAGATGACTGACTGAGTGTGGCCT
ACCCCCACCACACCCCTGTGGTTGAT	GCCTTCAATCTTTGAGAAAGCACCTTG
CCCACTCCCACCACCAGCCACAATACT	GCAGGCTGCCTGCTCTATCTACGT
GGGAAAGTCTTCACCTATTGTCCTGTT	AGATTTGGGTCTCACCTAGCCCCTGGA
AGTCTGTCTTTTAATTCTTTCCTTCCT	TCATCAGCCAGAGATAACCAATGTACA
AATCTCTTCTACCAATCCTCCCACCT	ATCTTCTCCTTCAAGTCTTTCATTTCCC
TAGTGCTAAGCCAGGTTCTCTCAGTTG	AACCAGGTTGGTAGGGTGTGGGCCATG
GAACAGGGCTGAAGGCCAGGCC	CTAAAAACAGCACTGCCTGTGGCTTA
GACAGGCTCAGTACTGGAGATTCATTT	AGTGGGAGTCCTAAGCCTAGGTCAGCC
GAAGAGAGAAGAGGGGGAGAAGCTGAA	CCCCTTCAGCTCCCGGAGTTTCTCAT
CCATTATTGTGGACTCGGAGAAGACA	CCAAGCTAGTGATTGATGTGATTCGCT
CCTTGATATACTGAATACAGTCCCGGC	TATGGAAAGGGGGACAGACTAGAATCT
AGGAAATGAGTTCCCTCTCTGCTCTT	CTACAAAGTGAGGGCACACAGGAGTTA
TGAAGAGAATCAGAAGCGGATTGAGAA	CAGTCCCTAGAAGAGCAGAAGAAGCTA
CTTGCTAGTGGTGATGTATTCCTCCAG	AGGAGGCCTACTAAAAAGCAGACATAG
CCATCATCCCTAATCTTATAACTATAGCCC	TCAGCAGATGTCAGCCCAGGGATCT
CAAGAAGTCTCTGCAGAATGCTCAGAA	TTGGTCATCCCTGTTCTCCTTCCCTGT
CATGTCACCTTTACGCTTCTTGTAGTG	AGGGAATTACTTAAAAGAACATGGGCG
ACAAGTTGCAGGCCCAGGTCTG	ACCTGAGCCCGTACTACCTCATCCTT
GGCTGAAGAGGACACACAGTTTAATTA	CAGCTGCAGCTCTTTAAGCTTTACCAT
TTCAGCCGCAATATTTTTCTTGCGATG	TCCTTCACCCAGAAAAAGTTACCAACT
AGATAGCCAATAACTGTTAAAAACGCCC	GCCAGCCTCACCCACCTACAATGACA
TCGTCCCTCTTCCCTTAGGTAAGTCA	AGAAAGCTCTCCTTGGGTCCTGGGAGG
GCACAAAGCTGATGGCATCCATGAGAT	TGCAGTTACTATATAGCAGCCAGAAGC
GTAGGAAAAGGGCGAGTTCGAGGCAA	CCACATTCTCCGGAGGGGGTCAAGTAA
TGCGCAGGGCCGCGGCCAGGTTTATCT	ATGTCGCGAGAATACGTCCAGGCCTAA
CATTGAGGTGTTCCAGAAGATGATAAAG	TTATATCAGCACTCATCAAGGCTCTGT
GAAGGGTTTTAATTCTTATCTTTCTGTCAC	CTGATTGGTATGGTAAGCCTTCTGAGT
GTGATATAACTTAACCACCTCGTATTTTT	ATGTTGTTCTTCCCAGTTCATTTGTAC
TGTAGTCGGTGGTAGATGATTGGATAG	GCAAAGGACAAAGTAAGAGAGAAAGTC
CCATATATTAACTTCTGACATTTGCAAATT	CTGTAATCCCACACTTTCAGAGGCC
ATGCATTCTAAATGAAATTGCTGTTTTAA	AGTCAGAGCATTTCGACATACAAGCAC
ACTGAAATTATCATCCCATTTCCAGGA	GTGAGTCAGACAATCCTGTAAGAAGTG
CTGTTAGATTAGTTTCACCATACTTTTACT	TGACCAACTTGGTCACCATTAATTAGG
CCTTTACAATTGAAAAGAAATGATGTGTT	CCACTGAGTCACTCTGGGCAAGTTATT
ATGCATCGTTTTTCCTTCCCCCATTC	TGCACCTCTCATTCATGAGTTATCTCC
AAGGAATGCTATGGTATGAAACATTTAAA	ACCAGTCGGTTCAAGGTTAGTATTACT
CTGAACATTAGTGCAAATATGCAACAA	AAAAGTTCCAGTTTGGAATTAAGCTCT
TAAAAGCACCTGTTACTGCTTATTTCT	CTACAGATCATATCGAAGCTTTCACAT
CTACCCAGTTCTCCTTTACTCCTTTGT	TTTTCTTTCTAGAAAGTGAGGTTAGTTGA
AAAAATTGGGGGAGTGGGGGAGTGGG	GGACCTTGTCTTCCTCTTCTTTTCATCAT
TCTAAGACCACATTGCTCTTTTTAAATTT	ATTTGATAGAAAAATCTTACTTCGTGCA
AAGAAATAAGCTAACTCTTTCTGACTTTT	TCCATTTTAGCCATGAAACAATTTTGT
CTTAATAAATACAGAAGTCTTTCTGTTCCT	TCTTTATATTTCACAGTACTCTGTAGATGC
CAGAAGACCTAAGCTATAGGTTTCCTT	CACGTTAAAAATATCACAATAAGAAAGCA
CCTATCATATATGCCTTAGTTTTGATGAAA	TCTTGAAGATTTTCTGCAAGAGGTATA
GCTTTCACCTTCTCTGAGTCACAGATT	GCCGGTTAAATTTATCTGCCAATTCAT
AGTTTTCACTTTGATGGTTCTTAATGTAT	CTGCATTCTGTTAACAGTCAAGTCCAA
GCAAATAAATAAAAACCTGCTCAGGCA	AAATGCAGTAAACTTTAAAATGCCCCC
TTGAAAACTGGAATCGAAAATGGAGAC	CAAAGGTTTGTGGTGGTTCAGTAGTG
CAGAAAACCACAGATTATGCCACCTTC	AGAGCTGCTTTCAGTTATCTTAGCAAG
CAAATGCAGAAGTAGAGTTAATAAAGCT	AGATGGTAATCTTTTTGTAAGCAACCT
TGGATTATAGCATGCTTTCCTCTTTTT	TAATAGTGCAGGTAATTTTATTGCCATC
GCGATCTGACTTGAAAGCCTATACTCT	TATCATCATCCTGTTCAATGAAGACAT
GATGCTTAATGTTTGGGACTTTTTCTCC	CATGGCTGCCATTGAATTCTTTAAGGG
TGTCAAGTAGTTTTAAGAGATAAAGCTCT	GTAGCAGTTGAAATTGGGCAAAGTGTG
AACTTTAACATGCTTTCTTTCTTTCCA	AATCTAGCCCTTTCATTTGGAATAACT
TAAAAGCTTGGCAAAGGAAGTAGTGAG	TTTGCTGGAAATGTCCTATTTAATTTCA
CAAAGCTAACAGTTTCGATTTCTTTTC	GCATGCAGCTTTCACTCAGTAAGGAT
TGTACCCAAAAAGTTGTGAGAACTGAG	CTCAACCACTTTCCGTTTTCCTGTAGA
GACTAAACCTCGTCGTTAATTTTCTTTTCC	CATCATCAAACACCTCTTGATTATAAGTA
CTCTCACTTACATGGCATGCTGAAGAT	TCAGTCTGCATTGGATAAACACTCATG
GCAATGAGCTATGTTAAACTGCGAACT	AGGACCAATCTTAGGTTGATCTGTTGG
ACATTAGTTCAGATCTTGACTTTGTTTTA	TACTTACCAAGAGAAGTAAGTTTTGCA
GCTAAACTAATGTCAACTTATTTCCTTTTT	AAACAGCTGGATGTGAGAAAAAGAGGC
AGATTTTCTCCCCTCTCTCTCTCTCAT	GGGCAGTTTTGTTTGCCTGAATAAACG
GAGTTTTGATTTTCTGGAATTCTTTTCCCC	ACCAGAGGGATAGCTGCATACAATAGG
TCCCTTCTCTGGTTGTATCTTCCATG	GAGTTGGTATTGGTGGGACACAAATTG
ATTTTTGGCTGGGGATCGTCAGGCTTGTC	TCTTCTCTGCAACTCGACCAACCAGG
GGGCAGACCCAGATGGCAGTGCTACAGAAA	GCTCCTGGACTCCACTCAACACCCAAAT
AAGTTAGTGGTAACCAGGGGCAGGGT	TGTCAGATGCGGGAAGCTTGAGCCCG
GAGAGAAGAATACTTTCATTTTGGCAACTC	GGCTTGTTCCAGTCCAAGTTGCCACTT
TGGAGCCGACAAGGGAACCGGGC	TGAATGGGGGACTGGGGCAGGGACGGA
CCTGTGCCAGCTTCTGCTCCCCCTTCA	CCCCTCCGTCTGTGCCCATGCCCACT
AGAGGTGGGAATGGCAGCTGGCGTGGC	ATGGGAGCCAGAACCGGAGTGGGGACG
CATCTTTACTCCAGCCCCTACACCCAT	TCCAAGCTGTGGGCAGCCACTCAGTGT
TTGGAATCCGAAGTCAGAGGCCGGGCC	ATATATACCAGCGGCTGGCTCGGGGTCAGC
CCCAGGCGTGCTAGCCTCCCCCGAGCT	CTGCCAAGGTGCTTCCAACTCCACA
ATCTCGCTGCACTCAGGTGGAGAGGC	TAACAAGGGAGGTATCTGCCAAAGGCCCAG
AGGGACTTCCGTTACCTTCTCTCCTCTTA	ACAGTCCTGTCTAGGTCTCAGCG
ATGCAGGCACTGGGTTGGCCACTCCCAC	AGAGGAGGGCCTTGCTGCTGGTGTGC
ACTGATCAGCACCATTCCTGGCACCTA	GGTGCTGAGGGACAGCCAAGCACAGTGAAA
AACAGGCAGGACCTGGGTGCTGGTAG	ACCAGTGCCCTTAGGCTCTCCTTG
GTGGAAACCCACGGGGCCGGCAAATATTTA	GTGTGCCATCTCTCAGCTCCAGCGAA
AGACAGTGCCAGGGTCCCAGTCTGAGG	AGAAAACTCCGAAACAACGCTGGTGGG
AGTCAATCCTGTCCTCTTGACCCTCA	AAGTGCTGGCCACCTACATGTCCCAT
GCAGGTGGCTAAATTGAAGACCACAT	TTAGGCTTCGTGTCTCCTGCCAGCTTC
CGAGTGAAAATGGAGAAGGTGGATGGT	AGCAGCAGCTCCAGCCACAAGCCAA
CTTTTACAAAAGCCTTCCAATCCGTTC	TTCACTGTCCTTCTCTTTGCCGCACTT
GACCTCAGACCTGACCCTCTACCTCT	GAGGGATCCCCAGGGCACAGTGGTGA
TGTCCCCAAACCACACATCACTC	GTCGAGTTGGGAATTTGATTCACTGTG
GACCATCCTCTGTACATCCCATCCA	GCACCTGTGGCGAGCCCGAGAAAT
TTACCTGCTCTCCCTTTCCGCCGCTG	TTCGGCCCTGGCTCAGCAGAGACTT
AGTACCTGACAGAGCAAGAAGACGA	GGTTGACATTGAATGAGTTCGGATTGG
CCGTTCTTTTCCTGTTTCTTGCCTTC	TCAGGAAAACGAAAGTGCAAGACCAAG
CTTTAGTTCCCATTCTTCAAATCCACC	GGCTTTTCTGAATTTTCAAGGCAGGCT
CTGACCTAGGACTGCATCTCTGCTTT	GGCGGCGCGTCTTGGCTATAAGGTAA
CCAAATTGACATTCAAGCAAGTTTGCA	TCTGCAGGAGGGTCTCACCAGCATT
TCATGGAGTTGTCCCTGTCCCCA	AGCTCAGCCTCTCACTCAAAAGACCTT
TGTTATCCTCACCCTGTATCACCTCCA	TCTGATTCCTGAACTTGTGAGGACATC
GTCTCACTGCCTGCTCTTCTTTCAT	GCAGACTCAGAAGTCATTTGTCGAAAC
GTCCTAATCCCCTATATGCTCCCCTTA	CACTCAGTAGGAAGGTGGAGTTCTCCA
TCAATAACTCCCATCCTTGCCTTTGC	GAGCTGGTGCGGTACGAGCCAGACCTA
AAAAACAGTCCAGTCGCTAATGCTGGC	ACAGTCTCAGAGGAGCCTGGGGG
CCAAGAAGGGAACCCCAGGAAG	CCCTGGCCCTGGGCTTGTGGGGCT
ACGCCACCCATCACCAAGCTCA	ACTATCTCCGCTGTGACTCCACT
GGCTTCTTTTCATCCTCCTCCAGCACT	CACTTGCAAAGCACTAGTATGTTCCTC
CCTGGGCCGACATCCCCATCTCATTT	AAGCTGGGGGCTGGGACTCTCAGACAT
TCACTGCAGAGGGGTCGGAGCTACAC	TTCTCTCTGCACTAAGGGCAGCTGCAC
GCAGGAGGCCGAACAGGCCCAGGATGA	TTGGTGGCCCCAGCCTGGCTGGCA
AACGCTCAGAACCAGTCCTTCTGTGA	AGTACAGTCCTCACCCTGATGACCT
CCTGGATCTCCTTGGTGACCGCTCT	GACTCGCCGCGGCTCCTTACACTCTAA
CACCAGTTACCTGTCCTGGTCATTTA	CTGAGCTTGTGCTTAGTAAGAACTAGG
CAGCTGGACTGATATGTGATTTATTCT	CAATCAGGCTTAAATCCTCCACTCTCC
CCTGAGTCATTTCTTCCTTTTCCATGC	CTCTAAAGTCAGGTGTTGCTTCTAGAG
