GTGTTGGACAGTGTAGCACTCTA	GTCCTTCTACTGTCCTGGCTACT
CCAGGAGAATGAATTGACACTAATCTCT	GAGCTGGACACCTACCTGATAC
TCCTACTTTGACACTTTGAATGCTCTTT	CTGTGCTATATGGGGTCCTTTTGC
AGTCCTACTTTGACACTTTGAATGCTC	TACCTGTGCTATATGGGGTCCTT
GCAGTGATTTTACATCTAAATGTCC	GGACACAATATTCTCTCCTGTG
CCATTGAGAGGTCTTGCTATAAG	CAACTGGAATGGATGGTACAG
TCCTCTCTTCTTCCAGATCTTC	TAAGCAAGATCCCACGATG
GCTTGTCCCTGGGAAGTAG	GGCTAGAAATCTGTTGCTATGG
TCAGAGGAGATGTGGTCAATG	CACCACTCTGTATTCCACTCC
GCTTCTCTTTCTCTTATCCTGATG	CAGGACAGAAAGGTAAAGCTCC
TGACCTCTCTATCTCCGTGAA	CTAACCAGAGATATTCATTCAGTCA
ATGCTGAGTTTGTGTGTGAAC	CTTTAACACCTCAGAATTGCATT
AAACTGAGGCTCTTTAGCTTCTTA	TTCTAGGAATTGCGGGAGG
GGAATATTTGATTTAATTTCAGATGC	CATCTGCTGCATAAAACCAC
CGTGTAGAACGTGCAGGAT	CCAGAAAACACCACATCACT
AGAAAGGGTCAACAAAAGAATGTCCAT	CAACATTCTGGAAAGAGTTTTATG
AAGAAAGTGTGAGCAGGGAGAAG	TTTGTGAGTGTATCCATATGTATCTCCCT
TCAGCTCGTGTTGGCAACATA	TTGACAGCTTCAACAGAAAGGGT
ACAGAGACCAGAACTTTGTAATTCAACA	CTTCAACCTCTGCATTGAAAGTTCC
GTGTAAATTAAACTTCTCCCATTCC	CCATCTTCAACCTCTGCATTG
GAGGAGCTCATTAAGGTTGTTGATGT	CTGCTGTATTGGAACAAACACTTTGATT
CAATTGGTGGCGATGGTTTTCT	AGCAACAGCTGGAAGAGTCTG
TTCACAGAAAAGTAGTGAATACCCTA	ATGCTGTGGTATCTGACATCTT
AACCTGAATTATCACTATCAGAACAAAGCA	CCTTTCTGCTGACAAGTTTGAGG
GTTCCCTTGATGTCTACAATTTC	GCAAATTACTGAAAGATGGTGG
CCTTAACTTGTTTACAGCGATG	CAGATTCGCATATACATGGCC
CAGCAGGAAATGGCTGAACTAGA	CTGATATCTTAAGCAAAATTCTTTCC
CTGGCTCCCATGCTGTTCTA	CGATAAATGGCACCAAGAAAA
TACTAGGTGATTTCAATTCCTGTGCTA	GTTAGAACAGCATGGGAGCCA
GTGAAACAAGCGTCTCTGAAG	CATTCTTAGGTTTGCTGACATC
CAGCAAGTTGCAGCGTTTA	CAGAGTGACATTTTAACCACTCA
CTGAGTGACAAGGAATTGGTT	AGAAGTGAGCTAAATGTTTATGCTT
GCTTGTTTTCTTCACAGTGCAGT	CAGATGATGAAGAAAGAGGAACG
ATATTGGCAAAGGCATCTCAG	GAAGACTTGACTGCAAATACAAACACC
CCTTCTCAGTCTACTAGGCATAGC	CATCACCTTAGTGAGGAAACAA
CCTTTCACCCATACACATTTGGCT	CTACCGAGTGTCTGTCTAAGAACA
ACACCTGATGACCTGTTAGATG	TTACCGAAGAGGGGCCAAGA
CAGACTGTTAATACAGATTTCTCTCC	GATACTAGTTTTGCTGAAAATGACA
GGGTTTTGCAACCTGAGGTCTATAA	GAACAGCCTATGGGAAGTAGTC
TGATGAAAACATTCAAGCAGAACTAGGT	TCTTCCTGGAAGTAATTGTAAGCATCC
TGAGAACATTCCAAGTACAGTGAG	AGAGGGCCAAAATTGAATGCTATG
TTTCCCATCAAGTCATTTGTTA	TAGCCGTAATAACATTAGAGAAAATG
GGTTTTGTCTATCATCTCAGTTCA	AAATCTGCTAGAGGAAAACTTTGA
TTCCTGTGGTTGGTCAGAAAG	TTACAAAACCCATATCGTATACCACCAC
GTCCTTAAAGAAACAAAGTCCAA	TAAGCCAGTTGATAATGCCA
TCAGTATTTGCAGAATACATTCAA	CACTTTTGAATGTGAACAAAAGG
TGTTCCAAAGATAATAGAAATGACAC	TTCAAAGCGCCAGTCATTT
ATCTCGTTACTGGAAGTTAGCAC	CTTTAAGTATCCATTGGGACATG
CTGAAGACCCCAAAGATCTCATGTTA	GGCAAAAACAGAACCAAATAAATGTGTG
CACCTGGTTCTTTTACTAAGTGTTCAAA	GAAAGGGTTTTGCAAACTGAAAGATCT
CAGCAGAAACCTACAACTCATGGA	TAAAGAATTTGTCAATCCTAGCCTTCCAA
TGCGCTTGAACTAGTAGTCAGTAGA	AAAGAACCTGCAACTGGAGCC
AAGAATCTGCTTTCAAAACGA	TAAGCCCACCTAATTGTACTGAATTGC
GGAGCAGAATGGTCAAGTG	TGAACCTATAAGCAGCAGTATAAGC
GAGACCTACATCAGGCCTTC	GGTCATGAGAATAAAACAAAAGG
GAAAACCTATCGGAAGAAGGCAAG	ATCCTGAGGATTTTATCAAGAAAGCA
GTAAAAGTGAAAGAGTTCACTCCA	CCCAACTTAAGCCATGTAACTGAAAATC
TTCTGATGACTCACATGATGGG	GAGAGTAATATTGAAGACAAAATATTTG
CCATGCTCAGAGAATCCTAGAG	CAAATGCCAAAGTAGCTGATG
GATGGGCTGGAAGTAAGGAAACA	CTTGGATAACACTAAATAGCAGCA
GCACAAATACTCATGCCAGCTC	TGATAGGCGGACTCCCAGC
TGAGACGGATGTAACAAATACTG	AGCATGAGAACAGCAGTTTATTACTCA
CCAGTTGGTTGATTTCCAC	AACATCATCAACCCAGTAATAATG
GGACTCTGTCTTTTCCCTATAGTG	ACAGGCACTGAAAAGAGAGTG
TCACTAACTAAATAAGATTGGTCAGC	GAGATCAAGAATTGTTACAAATCACC
AGTTGAATATCTGTTTTTCAACAAGTACATTT	GTCTATGAAGCTGGTATTTTCCTATTTAGTTAA
TGAGAACTCTGAGGACAAAGC	CTTGGTCATAATTTGTATTTGTGG
TTGCTTGACTGTTCTTTACCATAC	CATTGAATTGGGTAAGGGTCT
TGTTAGCTGACTGATGATGGTC	CAACTCTCTAACCTTGGAACTGT
CGTGCCAAAAGACTTCTACAGAGT	AGGCTAGAAGCAGTCCTCCT
CCCTTGTATTTTACAGATGCAAAC	GAACCCGAAAATCCTTCCT
CAACAAAGAGCATACATAGGGTTT	CTCTCCTGAACATCTAAAAGATGA
TCTCAAACAATTTAATTTCAGGAG	CAAGTGCTGTCCATGAAAAC
GGTTTTCTACTGTTGCTGCATC	CGAGATTTAGTCAACTTGTTGAAG
TGCTGAAACTTCTCAACCAGA	AACATAGCGTTCCTATAAAACCA
TGGCTCTTAAGGGCAGTTG	AGAAAGGGCCTTCACAGTG
CCTACCCTGCTAGTCTGGAGT	GGAAACACCTAACTTTATAGAAGCTT
CGAACTTGAGGCCTTATGTT	TCAAGGAACCTGTCTCCAC
CGCGTTGAAGAAGTACAAAATGTCA	ACAGAATTGACCTTACATACTAGGGAAGA
TTCTAATGTGTTAAAGTTCATTGGAACAGAAA	CATCTGGTAAGTCAGCACAAGAGT
GACGTTGTCATTAGTTCTTTGGTTTGTA	TGGATTTATCTGCTCTTCGCGTT
TAAAATTTGTCAATACCTGCTTTG	ACCAAAATGCACTTACACAGG
GTTTATGGTTCTAAGCAACACTGT	AAATGTTGGCCTCTCTTTGG
AGGTTTGGTTCGTAATTGTTG	ACCTTAGTTTTAACCAGTGACAGAC
TTCTTTTACAGGAGATTGGTACAG	ATGTTCAGATTCTTCTGCAGG
GCTAAGATTTTAACACAGGTTTGC	CCTTGCTCTTTGAATATTATTGG
ACAAGAATTTAGAAGTGGACAGG	CTCTGGATTATAAATTTGCATTCTT
CTACCAGGCTCTTAGCCAAA	CACTGTGCGAAGACTTTTATGT
TCTACCAGGCTCTTAGCCAAA	CCATTTTAGTTTTCACTGTGCG
CCTGACTTATCTCTTTGTGGTG	AAGATTCTCATTCATATAAATTGTTGG
CCTTCACAAACTTTGGTGTATG	CAACAGGACTAAAATAAAACAAAGC
AGATTTGTAAATCTCAGGGCAAAGGT	CAAACTCCCACATACCACTGG
GGTGGGTGGTGTAGCTAAAGA	GAAATGCCCTGATCATTAAGG
ACAATTATCAACCTCATCTGCTCTTTCT	TTTTGGTGTCTGACGACCCTG
TTAGAGATGACAATTATCAACCTCA	ATCAGGATCCACCTCAGCT
CCAAAATTGTTAGCAATTTCAA	AAAGCACATCTACTATTTGATTACATG
AAGGCATTCCAAAATTGTTAGC	TTTGTCAGACATCAAAAAGCACA	
TTGCAGCTTCTCTTTGATTTGTGTTT	CTCTCAATGCACATATAGTAGTAGTCC
AAACCGAGATCACGGGTGAC	TGTCTGTCACAGAAGCGATAAATCTATC
CATTTGGCATTGACTTTCC	TCACAACCTTTCTCATAGAAACA
TCTTCTTCAGAGGTATCTACAACTGT	TCCTGTTAAAGTATAAAACAGAAGCA
TTCATCAGCGTTTGCTTCA	TCATCTTCTAGGACATTTGGC
GCTTCTGATTTGCTACATTTGA	TTTCCTAGTCTTGCTAGTTCTTACTTT
GGCTCCATTTAGACCTGAAAG	CATTTGGTTCCACTTCAGATACA
TGGTCACATGAAGAAATATGCAATAGGG	TTGTCACTTCCACTCTCAAAGGG
GGCTAGAAATACGTGGCAAAG	TCTCCATCTGGGCTCCATTTAGA
TATTGCCTGCTTTACTGCAAG	TTCTCTGAAGTAAGAAAATCTTTCTTT
AAACTTGCATTGAAAGTCTCTTTAG	TCAAGATGCTGCTCTTCATC
TGTATTTCCAGTCCACTTTCAG	GAAGAAGCCACTGGAGAAGTT
GGCCAGCTTCCATTATCAA	 CTGAATATAGACTTTTTGATACCCTGAA
TTCCTTTATAAGATGTTTCATCATG	AGTCCTCCTTCTGTGAGCAAAC
TTCAAAAGCATTTGCTTCAA	GGATATTAAACCTGCATTCTTCA
AAACACAGAAGGAATCGTCAT	CTGGGCTGAACAGTTAATTAGTT
GAACATTTCCTCAGAATTGTCC	AAGTACCATCAATCACATTCACTAA
GCATGACAGAGAATCAGCTTC	GAGCTAGTTAAGGACAAAGTTGGTTCT
CTGCAGCCAAGACCTCTT	CCTTATTACATTTTGCTTCTTTATAATCA
CATATAAAAGACTTTTCTGGGATTG	TTCACACTGTCCTTCCTGC
TTGTTACCTTTGAGCTTGTCTG	GTTGTACTGGGTGACATGCTG
TGGCAACAGCTCAACGTTTTTATAATTT	TGACAGAACATCCTTGGAAG
TGTGTTTTGGTTGAATTGTACCT	AGCACATACATCTTGATTCTTTTCCATG
TCCTTTCATTAGCTACTTGGAAGACAAAA	TGAAGGTGATGCTACTCTCATG
GTAGAGTTCTTGAAAATGGGTTCGTTT	TGAGAAAAGTTCTTCAGAGTCTGGATTG
TTCTCCTCTGCAAGAACATAAACCA	AAGTCAAGTCTGTTTCATGAAGTTCCT
AATTGGACCTAAGAGTCCTGC	TTTTTTAATTGACACTTGGGTTGCTT
AATGTTATGTTCAGAGAGCTTGATT	TTCAAGGAGATGTCCGATTT
TGCAGATACAGTATTAATTGACTGAG	CTGTTCTGAAGCTACCTCCAA
TTTGGCTAGGTGTTAAATTATGG	GCTTGCTCAGTTTCTTTTGAT
TCAAATGTACTCTTCTGCAATATGT	AAATCCTGCTTGGAAAATAACA
CTGCATTCCTCAGAAGTGGTC	CAAACTGACTTCCTGATTCTTCT
CTGTACCTTCAAATTGCTTGC	GTCATCTGGTTTTCAGGCACTTC
GAGCAGAATAAAAGCCCCTAA	TACCTGACCAATCGATGGG
CCTCTGCAGAAGTTTCCTCACTAATATTC	AACCAGAAGCACTTTTGTTACAGTCA
TTGAAACAACAGAATCATGACA	TCACTAAACAGTTTCACAGCTTTTTGC
AAAGTGCCAGTAGTCATTTCAA	CTTATTGGATGTACCTCTGCAG
CACTGCCATCAAATTCTAAGTTATG	TTGTAATATCAGTTGGCATTTATTATT
TCTGACAAATCTTCTTTAATCTGAGT	CTGGCAGCAGTATATTTGTTATCT
CCACTTGCAGTCTGAAAAAATGTATCA	CTCCTTCATAAACTGGCCA
TGCAATTCTTCTGGTTTCTGATCAAAGA	ATTTTGCTCCGTTTTAGTAGCAGTTAAC
TGTCCATTTTGTTCTTTCTTATGTC	ATTTTATTAAATGACTCTTTGGCGACAC
TTGTCCCTGGAAGGTCACT	CAGAATTTAAGGAAAAGTTATGCA
GGTTTTTCACTTTGTCCAAAGATTCCTT	ACCAACTGGGACACTTTCTTTCA
GTACTTTAGGGTCTTTGCCCATTGA	TTTAACTTTTTTCCCGCTAGCTGTATGA
ACCACAGTCTCAATAGAAACAAGGTTTT	AAAACTGGTGATTTCACTAGTACCTTGC
GCAGGACTTTTTGCTGTTTCTTTTTCTA	AATTCTGCATTTCTTTACACTTTGGGG
GCTAAGGCTGAATTTTCAATG	TTGTCTACATAAATTATCACTTAAGAGCT
GACCATCAAATATTCCTTCTCTAAGCCA	ACTGATTTGTGTAACAAGTTGCAGG
TCATTTTCAGCTATAGTACTGTTTGA	TGAAGTCTGACTCACAGAAGTTT
TCAGAATGGTAGGAATAGCTGTT	ATCTGCAGTATTTATTCTTTCTGGTT
TTTGATCTTCAACATTCTTCAATACT	GTCATTTTCAGCTATAGTACTGTTTGA
TGAAGAGCTAGTCACAAGTTCC	GCTCAATACCAGAATCAAGTTTATT
TGTGAAACACAAACGATTTTACC	CAACGCAAATATCTTCATTTACA
AGAATATCCTCTGAATCATCCAATGCC	TAAATGCAGGTGGCCCTACC
CTTCACTCTGAATGTCAGCAA	AACAACCTGCCATAATTTTCGTTTGG
TCCAAACTAACATCACAAGGTG	CTTATGTGAATGCGTGCTACA
TGGACAGATTTTCCACTTGC	ACTTTCTCCAATCCAGACATATTTTGGT
TTCGTTACTTTTAAACAATACTTTGG	CAAGTATTTGCAGATGAGACTGA
GAAACTTGCTTTCCACTTGCTGTA	TTGCTTGGTACTATCTTCTATTTCAG
GTCTAGACGTAGGTGAATAGTGAAGACT	ATCCAGAGAAAGCAGATGAATTTACCA
TTTACACAGTGCTCTGGGTTT	ATTCCTCTAACACTCCCTTAACTTTGTG
TTGTTTGTCTTGTTGAAATTGAG	CTCTTATCAACACGAGGAAGTATTT
GTTCTTTTCCCAAAACATGAA	AACCACCTTCAACATTTAAGTTATTT
GCTTTAGCAATTTCTACTGCTTC	CTCAACAAGTGACACTTTGGTT
AATTCTTGAATTTGACAAAACCA	TGTTTCAAAGTAGTTTTCTGAATCTT
TAGTGATTGGCAACACGAAAG	GAGAATGTGTGGCATGACTTG
TGGCTGAAAAGACATAGTTTATAACA	CTAAGATAAGGGGCTCTCCTCT
TTTTTCTTGATTTTCTATTATCCTGTCAAATTC	TTAAAGCTAAAGTATTGACTCTTTAAATGTTAAA
GTGCTTTTTGAAGCCTTTAAGGAT	GCAAATAATATCAGTTTTATTTCTCAAAAGTCTA
CCATACCTATAGAGGGAGAACAGAT	TTGATTGAGGGTTCTCCTAAA
TCGGCTCTAAAGAAACATGATGCATAAA	CAATTTTCAGTGAATGTAACAGATGCTCAA
GGAAGTGTTAACTTCTTAACGTTAGTGT	TTCGATCTTTTATTGTGCCTAGGAAACA
GAGATTTAGACAGAAATTCTTGACC	TGTTGCAGACCCTCATTTG
AAATGGATGTCCTGAAACTGC	GTTCCTTAGTTGTGCTGCAAT
GGTGGAACAAAGACTTTGGT	TCAGATGTTCATACAAATGAGATTT
GAGCCATGTCCATCAATGT	CTGCCTGTAGTAATCAAGTGTCTC
TCTTCACACTTTGTGAAAGTTACA	TCCTCCAAGTTAATATTCCTAACAC
TTTAACAACGGAAATATCTAACTGAA	TGATGAATCTCATTGTCATTAATCT
TGCCTGGCTGTGGAAA	AAAGCACAACCCCTGG
CTCCTACTGCTGCTTTCAGAG	CTGGCATTCTGAAGACTTGTAA
CACTCTGTCATAAAAGCCATCAG	ATACAGACTGCCTGGCTGTG
TGCAATGTTTAGAAACGCCATACGTATA	AACCAAAACTGAATTTACCAAAAATTTTCATT
TTCCTTTTCCAGTCCATAAACTTTCCTT	CAGCTACACAAAATAAACACACACAAAAAAG
AGAAGAAAGAGGGATGAGGGAATACA	AGTGTGAAACTGAAAAGACTCTGCA
CATTCCATAGCTGCCAGTT	AACCACATAGGATGATACTGAATTC
CGTAATGTAATGCTTTAAACTTGC	TCCATCTATAGTGATTATAAACCCAA
GGATGGCAACTGTCACTGA	GAAGAAGCACCCTTTCTGG
GCTCAATGAAATTATGTCAGAAACACAGA	TGTGACTCTAGAATTCCACTGTTTAAAC
CAGCATACCACCCATCTGTA	TGTGTCATCCCTTTCCATT
CCAGTTCTGCTCCATGAAGA	TTTGGGTATCTGCACTACTAGTTTTA
TCTAGAATTTAACTGAATCAATGACTG	TTCTGACCAACTGTCAGTCTG
GGTCAGGAAAGAATCCAAGTTTGGTATA	TCATAAGAGTTTTCATTCTTCTAGAACTGCC
TTTGAATAATTACATCAACACAACC	TAGCAGAAATCTGGACAAATTAATAA
GCAAGAGACCGAAACTCCA	CTCCATCACTGAAAAGCGA
CCACATATTTTGCTGCTTCC	ATTGTATCAGGCCAGGCAC
CATGTTCTTCAAATTCCTCCTG	CTCCATCCACTGTAATAATGTGTT
AATGTTAAATTCAAAGTCTCTAAGACTTTGTTC	ATAAGGCTTCTAGTCTCTTTTGTTGGG
GCAAAGCACGAACTTGCTGT	AGCATAAAACACCCAAAGAAGGGA
ACAGCTTCTCACCTTGAATAATCATCAA	AGTGCACGTGATGGTAAATATGGT
CTTGTTTCTTATCATTCAACATTTG	GATGGCTTTAAACAGGACAAA
GGTTGTGACATCCCTTGATAAAC	GCTCTTAACTGCTCTTCACTGA
AAACAAAGCATTTACATACTTACCTG	TTTCCAACTGGATCTGAGC
GGATTTTGCTTCTCTGATATAAACTA	TTTGAATAGCTTACAATACGCAA
CTTTTAGATTTTGAAGTTGCAAGA	GCAATGGAAGAAGTGATTATCA
TTTGTCGCTGCTAACTGTATG	GATGGACGCCAAATACTCAGT
TGGAGATTCCATAAACTAACAAGC	TTTGAAGTTGCAAGATGATAAATT
AAATCCTATTAGGTCCACCTCA	TCAACATATGGAGATTCCATAAAC
CAACTGGTAGCTCCAACTAATCA	AACAAGATGGCTGAAAGTCTG
ACATATGAGGCTTAATAATGTCCTCATTA	AGATGTGTTAGATGAATTTTAAGATGCAA
CAGAAAACACAGAAAAATCTCCAGCAAA	GAAAGGGGCAAGTCCTAGAATGG
GCTATTTCCTTGATACTGGACTGTCA	AAGAAGGCCTGATTTGGATTCTGG
CCCTGAAGTACAGTCTTTAGTTGG	GCAAACCCACATATTTATGTTTC
CAACAGAATATACGATGGCCTC	GACCACTTGGGATCATTTG
GGTGTGGAAACAGACTTCC	ACTAAATCAAAGTAACTTTTCATTGAAA
GGCAGTCTACTCAAGAAATCCAA	CATACAAAGTGATAAAGGACTTTGAT
TTCGTATTTGGTGCCACAA	TTCTTTTGGTCATCAATCTCTTT
AACCAGACAAAAGAGCTTGGGTAT	GAAATGCCTTCTGTGCAGC
GAACTCTCCTGTTCTTTGATCAGAGAT	AATGCAAGTTCTTCGTCAGCTATTGA
CGTCAATAATTTATTGTCGCCTTTG	TAGTACAACGTCGTTTCAGTCTG
TTCCAGTCTTATAAACTGGAAAGGT	AACTCTCCTGTTCTTTGATCAGAG
CAGCTCGTTCCCTTGGAT	AGAAGGCTCAGAAACCGG
GGAGGCCGGTCTGAC	TGATGCAGTAGGGCCATC
GGCTCGTTCTCCAGGTAG	CGTAGACCTGCGCGTTG
AGGCTCTCCCTTCTCCC	GTGGGGCTGCAGGAAA
CCATAGCCATACTTCCCTTGTC	GATGCAGCAGATCCACTTTAT
ACAGGACCAGACTCCATAATG	GATTATCTGAATTTGGCCTGG
CTCAGTCGCTTTGGCTCTTAG	CTGAAGCATAGTCATTGCACA
TTTATCAATGGTGCACTGGT	CCTATCACTTCCTCAGCCTTAC
CCCTGGGAGAGATGTACCT	CCTATTAAAAGCAAGAGGACAGA
CTCCCCATCATCTCTCTGG	TCAAAGCTAACCAGCTTTCAT
AAGGCCAGGCTGTTCTTCT	ACATTCTCCCTCCTCTTCG
GTTGGTCAGTAAGCCCATCA	AGAGCGTTTGATCATGAGC
CACAACAAGTTCTTGAAAAGCTAT	ACTGAAGGGTCTGGTAGGATC
GATCTCTAGCCAGGCACATTCT 	TGACAAGGTCTATTTTCTACTAGATGGAGT
GTAAAGAACATGCTACTCCTAAGCTACAG 	CTGATCATGGAGGGTCAAATCCA
GCGGAACCGAGATGATGTA	GACATGAAAGGGTTCACATTC
CAAATAAACATTTCATCCAGCAT	ATGTCGAAGATCTCCACCATG
CATCAGGTGGATCAAAGTGTC	CAAAGAGGATGAGGTCTAGGAG
AGATGCCTCACCTCATGTG	GGATATGGTCCTTCTCTTCCA
ATTCTATGCCAGGAACTGTCA	CCTGATGTGGGAGAGGATG
ATCTCCAGCAGCAGGTCATA	AATCCCTAGAAGGGGAAGGAA
CAGCAGGGATTATCTGAACCGT	CAAGTGGCTTTGGTCCGTCT
TGCAAGGAATGCGATGAAGTAGAG 	 TCTTGCACTTCATGCTGTACAGAT
CGTTGGCAGGAAAAGCGTTAG	ATGTTGCAGTCCTGAAAGCC
CAGACTCTGGGGGATGGAATC	AGAGGGTGGTGGTAAGGAGG
CGTCTCTGTTGCTGCCGGTAT	TTACAAAAGCCACATTTGCG
CTGGGCTTAAAAGAACCATGC	CCCTACATGGCAAAATCCAC
CTTCCTCGTGACATATTTTCAATG	ACCAGGCTGACTGCAAAGTG
CTTTCGAACTCTGGCACCTTT	CAGTCCAGCTGTGCAAGAGA
CAGCGTTCACTTGGTGGAAGT	TTTCACGATTGCCAATACCA
CTCCTACTGCTGCTTTCAGAG	GAAGAAGCCACTGGAGAAGTT
