CTCTGCAGAAATGTGTGTACTCGCAAA	CCACGACCTGGCCCTGTTTTCT
AATTGGTACTTGTGTCTTTCAGCCAAT	CCCATCAGCATGTTGGGTCTAGA
ATTTTCCTGCATGCTCACAAGGATTGC	GTATCCTCAACTGTTATGCATTTCTGC
CATTTTCTCTTAGTTGTCCTTTGCCCC	GAGTAAGCAGAACTTTTTCTGTTCTGTG
ACAGTTCTGCACAGAGGATGTGGAT	AGGTAGCAGAAGGACGGATCTAGAAA
GACAGGCATTGGGCTGCAGCAGGCATT	TTTCCAGGCAAATCGTTTCAAGATGAA
CTGAAGTCATGAAGCGGGTCTATTCTA	ATGTACAGTGTGGAGAATCCACCAGA
AGTGTGACATTCCAGGACACTGCCAG	TCCCTAGTGTCCCAGGATTAGGGGA
CAGGCAGGTTGAGGCAGGTGCCACCAT	GATAACAAAACTCAGTACTGGCCACAG
AGACCCCTGTGAGAAGAACCGCTGC	ACTAATGAGACCAAAGCCAGTGGTT
CCTGGGCCACACAAGTCCCACCATTCT	CCTACAAGGACCACCTATAAAACTGCT
GAAACCCAGATTAGGTGGGAATGAATG	TCATATATTTTCTTTTTGCGATAGAACACT
TTTGAAGCAGGAGGAGGGGAGGAGAGA	TTCTCCCCCTCGGTCCTTCTCTGTGT
GTTACTCTATCACGGATCGTCGAAGTT	CAGATTCTTGGCTTGGCTTACAGATTT
AGCTGTTTAAACTCACGAACTTCATGG	CTATCCTGAGTCAGAGTGCATGAAAAA
CAGCACTTTTGCAACTACTAGAGATCA	TGTCAAGCACAACCCAAAATCTTGA
GGTGGGGAGAGTTTATTTACACGGTCT	TTGGACTTGATGCGACTTCTCAGGTA
ACAGATTTGCTTAACTAAAAACAGCAC	GGTCCCAATGGTAATGAGAGCATTTAC
GACATAAACAGCCAACACTGGCTCCAA	CAGTTTCAAAGCCAATATAGTGATCGG
TCCTAGGCAGCTTTTCAGAAGAGACG	CCTGCAAGATCTCGAGATGAAATATCT
TGGTCATTCGGACACGTGCACGAGT	GTCATCTCCAGCCAGTAATTTAAATGA
GGCTACCTATGAATTATTTCCTCAACACA	AGACATTTGTGGTAATGTAAGCAATTAAG
CCATTGTCCACAAATGCATTATAGTAG	AAATACAGTGCCTCATTTGTGAGTAGC
CTTTGAGCTACATTGCTTGCAATTCAGA	GGCTAATTTGTCCTTTTTCAAGAAACT
CAGTCATTTTCCTTGCAGATAAACTCTCC	TCAGAAAAATATCTAAGTCTATATGCTGCA
TGAGATCCTGGACCTTTCAGTGATATT	GGTAAAATTTCATTAATTCTCTACAAGCC
TTAATGCAGGAGAGGAGTCACTCACA	GAATGAGTTTACGCTAAAATTATCACCT
CTCAACTTCCGCTTGTCCACAAAAA	GTGCCTGGGATATTGGTCACTTTAAAC
AATAAATTTGCTTTTCAGGGAGTTTGG	ACGGCTCTTTGAACCTATTTGTGCCT
AACTGCAAGGTTATTTACTTTCCAGCG	AAAGTGTACAGCTTCCACTGAGATTTT
TCTCTGATGGCTCTATGGGAGTGGAT	TGAAGCAAAGGGAAAGCAATTACAGAA
TAAAACCCAGCAATGAAGACTCAGTGC	GGTGTTGAGGTGGCTAATTTTAAATTT
GTAGCATCGAGTGTCTTCTTTGTCTTC	TATTTTTGTGGACGGAATCGGAACACGC
ATGTATGCCCCGCCCCCTCCTCCTCCG	ATGTGATTGTGTGTGCACGCATGTGTG
ACAAAGTTAGAAGGGTCCATGGGAG	CCAGCGCTCGTGGTGGTAGTCGTCGTAT
AAAGGGCTTACTCTGTTAAGCCCAGAG	ACAGGGTCCATCCCGCCATGGCAAC
TCATCTTTGCCTCCACCTGTCCACAG	GAGTAGAATATTTTGGGCTTGTGGGG
ATGCCCATAGGTGGTGGCGGCATCATA	AAAGAGCAGGGACTTAGCAGGACATT
TGTTGGCTAGAAGCAGCTCTCAAGTG	CTTCCATCAAGATCAGTACCTGGGAAG
TTCAGAGAGTCGGCCCTACCACGGCATG	TCAGACCAGAAACCTTGGGGGCTTTGG
CTCCGGGCCCACCAGGACCACCTCCAT	GAAGAACAATGTTGCCATCCACATCC
GTTTTTCCCCTTTCTCTGTTTGTGTCC	CTGGGGGCTGGCTCTCTTGGTC
GGTATGTGATCAGTTTAAAGGAGAGTGT	GGCTGGCTCTTGCGGTTTCCTG
TCTACTTCCATAGGTTCTTCAGGTCTC	TAGGGCCTCCACCTAGGTTTCTGCTA
TCTCTAGAGGGAACACCCTGAAGAACA	GCACTTAACTGTCCATTGCATTTTCAC
ATAATCTTGGCATTGCACTCCTTCTCT	AGTTAAGACACCTTCTCACAGAAAGGC
CCTCAAGTCACCCATAATTAGCACTTGG	GAGTAACTGCTGGTCTATAGGATATAGAAT
GCGGCTTTTCTAAAACCAAATATTGGT	AGGTTGTGCCGCTCCTCTTCCAGCTTTTT
GGTTCCTCCGAAGAGTGTTGTATTAGG	ATCACAGAGATGGTTGCACTCAATCCG
GTTCACTGATCAGTCGTCCCTTTCAAA	GGGAAACAGTTTTAACCAGCTGACAGT
GTCTGCTGAGTTTCTGTGTAGTACCTT	ACGTTCTGCATCCAAATGCACTTT
GATGGGGGCCCTGACCGCGGCCTTCC	AGTCGGGCCGAGAGAGCGCGAGAGGCG
AGGCGGCGGAGGCAGCGCCGCGAA	CTTTTCCTCTGCGGCGGCTTCTCCTT
GGAATACGTAGACATTCGGTACAGTTCA	GGCTGAAAAGCCAAAATGAAAAATTTT
CAAATTTGATGAAAAGCGCCAACACG	GAAAAGAGGAGACAGTCCTACTGAAAAGC
ATCCACTGTTTTCTGTACCCGGAAGT	GCATTTGACCTTGTCATTCACACCAGT
GAAGCTACCTCTCAGCCTACTTTTCCT	AGATTACTTACTTTTCAGACATGGCCA
CAGGTGTTCTGACATAGCATTATCCTT	GGAACTTCTCATCAAGGCAGAAAAATCTTG
TTGCTTTGCCTGTGGTGGAAAATTGAG	AGTGCGGGTTTTTATTATGTGGGTAAG
ATGGATCATCTCCAGATTCCCAACACC	GCAAGCTGCTCAGGATTAACTAGAACA
AAATGCTTTTGCTGTGATGGTGGACTC	GTTTCGATGGACTTAAGACAACGAAGA
CAACTCTTGTCTTTTCACTCAAATAGC	TTTGAGGGATTATTTATACAAGTGAAATGA
ACCAACACAGTATATTTGAAAATGCAT	TCTTACCCATTGCAATGAAAATGACCC
GCTCTTTCTCTCTCCTCTTCCCTTATT	TGGAACAAAGAATTTAACACATATTAGGA
TGTTAGACTTACTCAATGCAGAAGATG	ATTTGAGTTGCTCATAAGTCAAAAATGT
GCTGCAATATTTCCTTTTACTAAAATCGTA	AAAAAGAAAACAAGCATAAACATGTTCAA
CGTCTTTACAAGCAAGAGAACTGATTG	ATAATTCAGGCTGAATGTGGTGACTCA
TCTTTCTTCTTGTAGTCTCCGCAATTG	GGGAGAAAAAGAAAAAGCATTACTATGA
CCTCTTTCTAGATCTACCAGTGGAAGA	TTCATGAAGAAGAACCAAAACATCGTC
GTGTTTGTAGTGCTACCTCTTTTTCGT	GAAATGTACGAACTGTACCCTTGATTG
CCCAGCCTAGTTCTATTTTCTTCCTTT	ATCTCGTATCACCACAACCTCTACCTC
GAATCTAGTGATTACAGTGTCCCTTGC	CTAAGTCATTTGTCTACCCCCAAACCT
TAGCAAGGTTACGCTAAAGGGTACAGC	TCACAGCGAGAGAGATCAGGAAGTT
TTTCGCCCCCGGCCAGGCTCCATCAT	AGAGCCTCCGAGCAGCTGGGCCGGCTC
CCAACCCAATGCTCAAGTAAAACCATC	TTGAGGGAGAGAAAAGTCATAGGACCC
AGCTAAACTGACAGGGTTTTCTGAGG	GGAAATGAGTAAAGGAAGAGATACTGAGCA
GAAACTAGAAGAGCTGAGTACATGGCT	TGGATACAAAGAAGACAGAAACCAACC
CATCTTATTCCCACCTATGCCTCCC	CCGAAGAAAGAGGAGGGGGAAGG
AGGGGACTATTTACTGGGGCTGGAATA	CTTTGGAAAAGGGGCCTTGACCACCATT
TTAGAGACTAAGGGAAGGCCAAGGACT	CTCTCCTCACCCCAAAGATTTAACTATCA
ACTGATGGCTCCTATCCCATCCACTT	TCACAGTTCTAGTCAAACAAGAGGCTG
TCCAGGAGGAGAGCAAGAATGGAG	GGGAAAAGATAACACAGTCAGTCACAG
ATAGAGAAACCAGCCAGCCCCTGAAGT	TGTTGGAGGCCACCCAGCCCCTGGAA
TTTTTCTGCCCTTCAGAGGTCACAC	ATCACAATCTTCACTCCCACCTGGCTC
CTCTCAGGAGGGGTTTGAAGATCTG	CCAGAACCAGAGAGGTCTGGCCTCAGTT
TGACCACCATCTTCATGGCCTGTTCC	TTTGATTCCTCCTCCTCCTGCTGTGGC
TCCAGGCTGTCCCCTCCAATGCCTCAT	GGAAAGGAAAGGTATCTGACACAACAC
TAGACAGAGAACAGAGACCCTGGAC	ATAGAGGGTAGGAGTGGGGTGGGGATA
GGGACTTGGGAACCCTGAGAACACAAA	CTTGTCTTTGCTTTGTTATGGACCCTC
GGTCCAGTAAAGAAAGGGAAAGGGATA	AGCCACAGGATCAGGGTGAGGC
TAGGCACAGAAAGAACAGGCAGCGTAT	AAAGACAGGCAGGAGGTTCCGCGGGCATTG
GCTGGGCCGAGGACAGGAGCCG	AGGGAGAGGCCAGTTATAGGGAGAGT
CTGCCAGCCTCTCTGCACCCCCTACTA	GGGTTATGGATGGATACAGGATGGATG
TTGATGTTGCCTGCGTCCAGTGCGGCA	TCTGGAAGAGATCCACAGGACTGTGG
GAGGTGAACACGGCCTTTGAGGACTT	GGATGGTGGTAGAAGCCCAGACCCTAA
ATCCTGCGTGCCTCCTCCTTCTCCCGCT	TGAGTGAGAAGGAATGGAGCAAGACA
TTCCGTGTCCCTTCTTTCCTCAGCT	CTGAGGGCAGCGGTGCTTCACCACTGA
TGAGTCACACACAAAACGCTCACGGAC	TTGAGGGGTGCTTGGGGCCAGGCTAC
GTCCAGGCCAGGCTGAGTGGGGCCTA	AGACCAGTTCAACAGAGACCTCAGT
CTGAGAAAGGGAGGCAAAGCCAGATTT	GGACATGGGGTGAAGCTGGGTTGTTTT
CCTCTGCACTGACATGTATCTGCTGAT	AGAACTGTTGTCCCAGACTGAGAGGAT
TTTCTCCTCAGGGTCTGTCTCACTCT	GAGATAGAAAAATCCCTACTAAGTCCC
GGCTCTGGACTCTTACAGAATAGTCCT	TGCAGGCTAAGGGTGAACTGTGCCTTT
CAGACCAGACTAAGGAAGAAGTCTGAG	TAAGGGCCGTGGAAGCTTGACCAGCGT
GTAATATGGGCGCATAACATGTGCAT	GAACAATTTAGTTTTAAGGACTTCATCCCT
GTAGAGGACTTGCCACAAAACAAACAT	TGTAGCAGCCAGGACTTTATAAAGCTT
GCACATGGCAGATCTCAATACGTGTTT	AGTTCAAGTCAGACTGTAATTTGGTTG
AGAGTGGTCTTAGGAAGATGATGCATT	CAGCTGCTGGCCTCCCTTGGCT
GGCAAAAGTGAAGACTGGCTCTATTTT	TGTATCCCTTAAAGTCTGCCTTTTCTC
ATGGACAAATGGATGGTGTGCTTTTAA	TCTAAGTAGTAGCACTTTAAAATGGAAATG
GTCTGAAAGCATGAAGCCATTTCCTAA	AAAAAGAAGGATGGTGAAACGCTTA
GCCCTCCTAAGAGTATGTTGTCTGCTA	AGGCTGGGTCAGGGTTTCGTAATTA
GCCTGGCTTCTCTCATAATTTTGAATT	AACCCACTTCCACGAAAATCACCTCA
ATGATCTCAAATGGGAGTTTCCAAGAG	CAGTATAGTGGAAGGACAGCAACAAAG
TGTAGAGTGGTTGTTAGGACTGAAAAT	AGCAAAGGTAAAAATTCATTATTCTTTCC
CCTAACTTCCAATCTGATGACAGCTCA	CAACAGTTGTTCTTGTGATATTCCACC
CCACCTTGGCTTCACAAAGTATTGGT	AAGGACATTGATGCCTCTTATAATGGA
CTTTAGCAAGTGAGGAGCATTTCAAGG	AAGTTAAATTGCCGAGAATTTGATTTTTAT
ATCTTCTCAATACGTTTCCCTATGAAT	GAGACCACAAAGGACTCTAAGATACCAT
AGTCTGGATTGAAAACATTAAATGCAA	TGCAGGCTGCTCACACAATCTTTA
GTTGCCCTAGGTTTTAATAAAACAGAG	ATAATTGTGGCAATGTGGTCTGAGGAG
GCTGATTTCTTCATAAAAGAGGAGTCA	TCTTAAAGTAGGGGAACCCTTATGGAT
CCATTTGACCCTTAAAACTGGCTCTAG	CACTATAATATCATGCACTTTCATTTTCAG
AGAATAGCAGCTACCATGGATGTGTC	TAGCAGCCCCTCAGAAAAGGATTCTA
GCTGGAGTACCAAACTGCCTTTTTAGT	AAGTCCAGCCTGCTACTAGTATTCCA
TATCTGCAACGTAGGTATCAGAATCCCCG	AGTGGAGGAATACCTTCTTGACATAAA
GGGGTCTCAACGCACACCCGAGGTCTT	GCTGCATTTCTAAAATGTTGTACGGAC
CACTTTGTTTTGTTGTTTGGTTGCAAG	TTATACCTTTAGCTGTTTTTCTCTAGAGA
AACCTCTCCGCTCCCGCCTCGGTCCCT	GCTCGCTCGCTCGCAGCCCCTC
AATCAGTGCTTAGTCACCGATACCTCG	CGGGTAACGCGCTTCCAACTCC
TTTCTGGCCATGACCAGGCCAGAAGG	TTCCAAAGTGGGGAGCACAAGTCAA
CGGTGTGGTGTTCAAGGTCTCCCACAA	CCAGGCTGGTGTGCAACCTCCATCT
TAGCTGGTCACCTCCCAGACCAAAGAT	GGAGAAAGGTGGAAGAAAGAGAGGTTTT
AGTGTATATAGACTCCAGACAGGGAAG	AGATCGAGAATACCAGACCAGTTAGTG
GTAGCAAGACCAAAAAGAGGGTAGGAG	GAGGAAAGGGAATGTAAAAGAAAAGAAAA
TGAGGCAGAGAAAAGACCTCTTTACTC	CATAGTCCAGGCCTTACAGTTCATTCTT
TTCTTGTCCCCTACCCAGCACAAGAC	GCAGGGAAGAGAAAATAGAAAAGGAGGG
AAGATGGGGACACACCAGGCTACTCAC	GCAGGAGAGACAGACAGTGATAATCA
GATGAGCAAGTAAATTCCAAGGTGAAG	CCAGAACAGGGTCATGGACAATAAACA
CATGCCACATAAGTCTTGGCACTCTAA	GCAAACACATGTTGAGATAAGAAAAATGCC
GAGCAAAGGAGACTGGTGTTTGGTATT	AAAGGAAGAAAGACAAGGTAAGAGCTG
CATGCTGTGTTCTTCATCCTTTGTCAC	ATGTAAGGAAACGAGAGGACGTGGTG
AGAAAACCTACCAGGGCAGCTACG	TTTATAGTTTACCCACTTAATGTGTGATC
CCAGAATGCAAGAAGCCCAGACGGAAA	GGACAGCATCAAATCATCCATTGCTTG
AGACCTGTGGGAAGCGAAAATTCCAT	CGGACGATATTGAACAATGGTTCACTG
TGAAAGACAAGAGCAGAAAGTCAGTCC	CATGAGACACTTCCAACCCTGGGTCA
GTCCCTCTCTGATTGTCTTTTCCTCAA	TGGATCCCCACTTTTCCTCTTGCAG
TACCTCCCCTCACCTACTCTGTCCCC	GTCTGTGGAGTGCAGGCTCCCA
CAAATTCCCCAAAACACAGTAACCCAA	AAAAACACGTTAACAGCTTATCCTTAAA
TGTCTCAGACAAAAGTCCATAGGACTG	CAGAACATAAAAGTTAGTTTCACTTTCTG
CTGAGAGAAAATAAAACCCCAGAGGCA	TGAACACCTTACATACACACCACCTAG
ACCAGCATGCAGCTGAACTTCGGAATT	TTTTTGAGACAAGTTCTTTTGCCCCTC
CAGTTTGGTGTTCTAGTTCAGCACAAT	ACTTATCAAATTAAGTATTAGGGGACAGG
TGTGAAACTATCACTCAAGTCATAACT	AGTTAACACAAATACAACTCAGAGCAA
TTGCTGTTGTTAGCATCCTGAATCAAA	CTGATATGGCTGGTAAGGATACGATTG
CTTTGTTTGCTCCAAGGAAAGGAAGAG	CTGTGGGATCTGGTACAGTTTTGTAAA
ATGGAAATAATTTTGCCCTCCTTACCT	TGACATTATTAGATAGGAACAAAATCCCT
GACGTGGTTGATGAAAACAACATGAAT	CAGAGGGAAAATAATACCAGGCAATGA
AAGCATGTTACCTTAAGATCAACCACC	GAAGTTTCTTCTATTCCAGATGTAGCT
CTGTCATTTTCCTACTTGTTCAGTCCA	ATGGACTGAGAATATGAAGAAAACACC
ACCGATAAAAGTGAACCTATTAATCTCTA	AACCCCAACAGAAAACAAAAGCCTTTA
TGCTGTTATCCTTTATAAACAAAAAGACT	TCACTATGTGCTGGTAAATTCACTCCA
TGGTCCCTTCGGTCAAGACTTAATATG	ATGTAGAAGGTGAATTCTGAGCCAGGC
CCAAAGCAGCAGGAATAGGATAAAGAC	GAGAAAAACAAAGACCAATAGGAAGAAAA
GTCTTGGCGTTTCAGCTAAACCCAATT	AACAAAACAAAAACATGGTATCAGACA
CATGGAATTCATTTTCCCCTTACCTCC	AGAAATAGACAGTGACTGCTAAAGGGT
ACATGCCAGAGATTGCTCAGGAAGCAA	GGTTTACTTGCTTTGTATCACATAGCA
ACCATAAAACCTTTGGAAGTGTAAGTT	AAAAGAGAAAGACAAAGAGAAGACTCA
GGAGGAAGGAGAAGCTGAAATAGAACC	GCAGTAACATAAAGTTCATTGTTACTAGCA
GATACAGAAAAAGTACAGAAGAAGCTG	TAAATAAATAAGCTTTACTGAAGCACTGA
TTGCTGACAGAGGCAAACTCCATGAA	GAGTCAAGGGTGGAAGACATATATTTGC
GCATAACCTCTTGCCCAACTATAACAC	AGTCTTCCACTGAGTTGTTAATATGCT
CTTGTAATATGCACGTATCTTGGATTT	AGCAAATACAACAGCAAATCAAGTTAC
ATGTGTGATCAGGAATAGCTTTTGAAG	AAGCTAATCCTTAACTATCCAAAAGCC
GTCACACATAGCTAGTAGCTACCACAT	GTTGCTTGTTCCCATTTTGCATGTGTA
CCCTCTGAAGACATCACTGAAATCATA	AACACAAAATTTTTGTGCAAAGCATGA
TGGGTCCAGTCAGTGAACGTAAGGGTT	TTTTGACTCCCAAGGACAGGTAAAGTG
CACACATACACACCAGAGTTCCTAAGA	ACTTGCTGATGGTATTCTTCAATTTGT
ACTACCAGTATCAGTGTGTAAGAGGTT	GAAAGAACAAATACATTAATGATTTGCCA
AACCGCATATCTACTCTTTTTCTGTAC	ATTATCAGATATAGACAAAAGAGAAGGCA
TTCAAACACAAAAGTTTGACATCTCAA	AGAATGGTGGAGAAAAGAGAAACAGC
TTTCCTATCCTAGTCCTGTCATGGGTA	AAAATTTAGAGACCATGAATCTTTCAAGT
CTTTCATTTGATCTCACCTATGGAGTG	GAGAAATAAAAAGACTGACCTTTACATAGT
CAATGCCAACGTAGACAGTGGTCTCAT	AGTTCTGACAAAAATCCTTCAACAAGGC
CTTTTCTTCCCCGCTTACTCTAATCAC	CCATAAATGTAGCTCTTGTCTGGAGAT
CAATCAGCCCTGCACATTCTGTACAT	GAGAACAAAACAAAATCAGGTTAGTGCA
GTGTGCTGAGGTATGTCAAGTAATGAT	TCCTACCAGGTTTGTCATCTTTTCACA
CAAAGACACCTTTCTCTAGTTTGTCCC	CCACTTCAAAGCTAACATGTTGCCAAT
TGGTAATCTCTAACTGTAAGCATACCT	GACATTAAGCCAAGTGCAACGTGTAGA
CTTCGAAGTGTGTGCCACTGTTTATAC	ACTTAGGCAACAGTTTGAAGTAAGAGA
TGAAATGAAAGCTATTTTGTGCCAGAA	CAGAACAGAGATGAGCACAAACAAGTC
CCCCCAAAACATCCTATACCTGATAGTA	AAAAGGATCTCACCAGAAGAGAGAACC
AAAGCTGAAAATTTAGTTGGAAGGGGA	AAAACAAGGAGTTGAGAATTGAGTATAAG
CATTGAAAGGCCGCATATGTTCTTCTT	TTTTAGGTAGTGTTTCTAACCTTCCCA
AGTATTGCCAATCATGTTCTCTTCACA	CCTGCTCTAGGTCAAGACATAGCTTGT
GCAAAGTAAAAAGCACTATTCATGACC	TCAAAAATGCAAAGTCATTAGAATTTTCAA
GGCAAACTCTCCTTCTCAACCAAAAAG	AAAAATTAGCAGTTCACATTTAGCACT
GGGAAAAACCAAACTTGCCATCTCTCT	AAGAAAAATAACAGAGTAATTATGAGGCTT
CAGCAGGAAAATCAGTCTAAATAGCCA	AACTATCATTACTGACCTAGACAGCCT
CAGTTATAGATATAGACTGCGGAGACGT	GCAGTGTTTAAAATAAATATACAGATGCCA
GTTGTTTTTCCTGGCTTTGCTTACGAC	GCTTTAGAAGAGGACCTGAAGGTATTCC
CGCGACAGCCTTACGTGACATTTTATA	AAGGTGGCAGCAGGTAGTTTCTGTTGT
AGTTCCCAGCGGGTCCGGATATGAAT	AAAGTGGTGGTGACGGGGTGAAGTGG
GGAGTGTGAAGCCATTGTCCAGTCTAT	GGGGTTTGTTGCTTTTAAAATGAGACC
GCTAAATCCAGAAATACACTCTTCCAAA	GGAGAAAACACAAATGAAGTTGTTTTAAA
CCAATGAGCCACACCTCACGTTAGAAT	ATCCTGTAACTGAAGGAACTCTGAAGG
AATACCTGCCCAAGGCTTCCCCATATT	AAAAATACACTATTAGCATGTGATGGTC
AACAGATGTACCCATCTATTCAAGCAA	AGCCAGAGAAAAGCTAGTTATTTGCAC
ACAGATATGCTATAGTACAGAAGGCAA	GGAAAATAACATGTTTTTAATCACTCTACC
GGTTTCAAGCAAGGTAATCACTTTTCT	ACAACATCTTATGTGGGATGATATTGC
TCCTAGAACTTACCACTAAAATGAAGC	CTAAAGTAGGAGTTGGAGATAAGCATG
TCATTCACTCTCTGTGTACTTGTTCAC	GTCATGTAGAGTTATCCCATAAGCGGA
GTGACTGTTTCCAAGGATGTCAAAGC	GAGAATAAAGGAACAAGTAAAGACAGAAAA
TCTCTCCTGGCTCCTATGAGAGAGAGA	AAAAACACTTGCATGGACTGTGTTATTGG
AGGACATACCTTTGAGCTAGTTCTGT	AGCATTAAGTACAAAATAGCACAATAAAC
CAACGTGCAAGTGGCTGGACCAGT	TATTAGCAAACGAGTGTCTCATGGGC
AGACAGCTTCTTTAGAGAAGACTTCTT	ACCCAAAGACAACAAGAGCTCTTGG
ACACTGATACCCAAAATGAATGCACTC	ACTGAATCTCGGAATGAATTCAGGAAC
GCAACAAGAAAAGATGGAAGAGTACTA	GGCAAAGAAGATATGTTTGAGGCTAGTA
GTAAGACATAAGGGCTAACTTACTTCA	TTAAAGATAATCATGAGATGGTTGATGAG
GCCACGCTCTGTGTATTCACTTCAAAT	CTCTGCAAGGAAAGGAAATATAACTCC
TGGTTAACAAACACAGAAATTGTGACA	GTTTTGCCAGAACATTTTTCTGTAGGA
GCTGCTTGCCTCCATTAGTTGGAAAAT	AAAAATTTAACAAATCACAAGTGTGACTT
ACCAAGCAACTTCTTAGTGTTGGCCT	CAAGTGGCTGTCCTATTTCCTAACAAC
ATGAGCCTGGACATGGGGCAACCTTCT	GAAATGAGAATGGGACCTTGAAACAGT
CACTCTAAAGATTCTAAGAAATGGCTGG	AAACAAAAGTTAAGAATATGCAAGTTCATT
AGGGCCTCCTAAAAGTAGACTGGAATA	GCAGCAAGATAGGGAATTAACGTGATCA
TTTTGAGTCCCCCACCCTCAAATTT	TTATGAATACTTAGCAGAGGCCAGTGT
CCCTCATTAAACCTACTGTCTCAAAGC	GAATTCGTTGATCAAACTCATCTGTGG
CGCATGTTAGCAAGTTCATCAACCATC	AAAGTCAACAGAGGAACATTTTAGAGG
AACACCATGCTGCCTCCTGGAAAAA	TCAAATTTTACTCTTATAACAAGCAAGGTA
GCAAGTGAGGTCATGGAATTAGAAAGG	AAGTAAATCCCCATCTGAAGCCAAAAA
GCCAGCTTAGTATCACTGCCAACCTTA	CTTCTTTACCTTGTAACTGACTTGACT
AGTACCAAGACCTTATAAAGTGGTGGC	AAAAAGCAAGTAAGTGATGTTCATAAGAT
GGTCACTAGTGAAGAGCCCATGTTAAG	GGAGAAAAAGAGAACAGCCAGTTACTTC
CGCCCGGCTGGTTCTAATATTTATAGA	GGTAGACAAGGGAGAATTAGTAATGAAGGT
ATGCTGAGTCACCGCCCACAAGGCCC	GCTTCGGAGATCACGCCACTGC
TACAGCCGCTCGAAGTCTCGGTCCCG	AATGGTAATGTCTGGGAATCCGAGAC
AGGTCGACCGAGATCGAGAACGAGT	CCATTATCTCGCCGCCAGACGCCATTT
TTCGCTTTCACGACAAGCGCGACG	TCACAAAGGTCCGCGGCGAAGCACGTG
GTCCATGGCATCCATAGCGTCCTCA	CCGGAGCCCCGCGAACTGGCGCCGGCTT
AAATTGCAGGGCCTTAAAGCGGCTGA	CAGGGTGAACTTGGTTTTTGGACAAG
GTCATATGGTGGAGCTGTGGGGTCATT	ATATCTTTCCGGTGCAAAGAAACAACC
CCCATCTCCCATCGGTTTTTGATTTTG	CAGAGAGACACTCGTTTTCTCTATAAG
TTTTTCTACCTAGTCCTTGTGCTGATG	AGAAAATGGTATCAGGTTTCCCTCCTG
TATCCCGGCGTTTCATCCATACCACAA	CAAAGCAAGCTAAAGCACTGGGTTTAG
CTATGAAGTTCCCATCATAATCACAGA	ATTGTCTTTTAGATTTCAGTTCTCTTGG
AATATTTGATTTGGGAGGATTACCCGA	CATAAAGCGGATTACAACTATGCTGCA
TTCAGGAATTCCTCCTATGAGTGGAAC	ACAGGTTAATTATTTGAATATATGTGCAGT
ATCAAGTAAATAGATCTGCAGCGTTCC	TTCCAGAACAAAGCCCCTTCTTGCTT
CCAGTTGCATTTGGAACTAAACCTGTA	TTTTTCTTGTATGTTGATGAAAGACAGTA
CAAATAGGATGTTTGTCCTTACTGTTGC	TGAAATGCTGTTTGTAGTGTTTTTGTA
CTTGGCTAATGGCACTTGATTTTCTGC	TTCTGGAAAACATGCATTAGCATGGTC
AAGTTGTCCTTCAGTGGTCCATGCC	TGTTCCTCGGGCCACTGATCTCTCCAA
CATGCTCTCCTTGCATTATAAAGAGCC	AGTACAGCCTGTCACTCACACAACT
CCCTGGAATGAAGGGTAACCATTCATT	AGCCAACCAAAAACTCTATTTGTGTTT
CTTGCTATTTTTGTAGCCTTATGATGA	ATAATAATTTGAAGATGACTTGAGGAAAGT
GCCCCATCTCTGATAATGAGCTCATTT	AGATTCCAACCAGCTGATAATTCTGTG
ACTGTGATTCCTATGCTTTCAGGTATT	AGGTGGCACAATTTTAACTGTTTTCAT
GAAAAGTACAATATGAGAGCAGTGAGCC	AGTATCCGAATATGGCTTTAGGGCTG
GCCATCTTCATCCACCTTAAAATCTGC	TTCATACTATGAAATGCCAGATGGTAG
TTGCTGACGGTCAGTATTCCAGTTATA	ACAAAAATTGCCTTATTCATTCCATAACA
GAGGCTTTATGCCAAGTGGAATGTTTC	ATCTCAAAAGATATATTTGTACATGCAGT
AAACTGCCTGGAGCCGTTTCTCCGCG	CTTTGTTCCCCGCGCCGCTGCGGGGC
TCTTTGCCGGGAGCTGCTTAAGGTTTC	GAGAAGCAAAGAGACAGTTAGGCATG
GACTGTAGAGATTGTCATGGAGTCCAG	AGAAATGGGTGGCAGGAGATGGTTT
TTTCTTCCTCCTTCGTGGCTTTGCTA	ACTGTCCGCGTTGGAGTTGGAATCCAC
ACCAGAAGGTGTCCCGTGCTGGAAAAA	TGTGTAACTTTTGACTTCCCCCAAAAC
AAGCCACCAGGTCATTGTCAGTTAGCT	GCAAAAGAATAAAGAAATTTTCTCAGTGAC
ATCCATGCGAAGTTATACTTCTTGTGC	GAAAATGAGGAGGCTGACTTAGATTTT
CTTTTCACAGTGAACCTGCAGTCTG	AATCCAAAAAGATCCAGCTTCACAATGC
CTTGGAGCCCATACTCTGTATAGCATG	TCTTTTAGACCCAGAGAGAATGTCTAG
TATGCCATGGATCTTTGCTCTCTTACC	TAAGGACAAAGTATCTGGTCCTTCATC
AGCAAGAAAGATACTGTTACGAGTGGA	TCCATACTTTTTGTGTGGAAACTTTGG
TGCTGGTGCTTTGGTTTTAAGGT	CTGAAAGTTGGAAATGAATACCGAAATGAA
TATGACACGGGCCTCCCACAGGACTT	CTTCCTTTGCAAAGGCCCAGGGTAAGAAA
TCCTTTGTACCTCCTCCATCTTGATCC	GGGCTCAAGAGCGGGGATCTTG
CTGAGTGCAACGGGCTTCAGCCCTT	CAGATAGTGCCCAAGAGGCATCA
AAGCCAAGGCTTTCTCTGGCATGATCT	GGAATAACCTTCCCTTTTCCCTTCTGTAT
AGACAGTCCATTAAAGCGGTGGTGGAA	GAGAAAGTTATCCCAGGAGGTGTGTCTA
TTATCAGAGGTGGCCATAACTGCCTCTCGA	CATTTCCACCAGTTTCAAGGCCAACT
ACTTGCAGCAAACCAAAACCTAGCAC	GACGATTCATGAGGGAACTTCCACCA
GTTTTGATGGTCTTCTTATCCAACACGC	ACTGTGAGCAAAGGCTGCTTCTTTG
GATGAAATTTCACAAGAAAGTTGGAAAGC	AGATTAATGTCAGCAAGAGGGGAACC
ATAGCTGCTGGTGAAGACGCCACAAGT	AGTTTGCTTTCAATGGCTGCTGCCCC
TTCCAGCCGTGCCTTCCAACTTTCAGT	TGGAAGCTGTCTCCACCCAGACTGAT
GTTGTCCAGGGAGCAGAAATCAAAAGA	GTTCCACTGTGTATTCCCTTTTGGGTT
GAAGAGCTCAGAATCCCGAAGGAGGTA	CACCAAGTTCCAAGTGTTCAGAATCTC
TTCATCTTGCTTGGGGTGAACCCAAAG	AAAAATAACAACCCCAAAGCTTTCAG
TTCCTGGGACGCCCGCGCCTCTTC	ACTGCGGGAGGGGAAGAGATAAGA
AATCAAAAACAGGCAACAACTTCGTGA	GCGGTCATCCACATGGCCCGGGA
TCTCACTCCCTCGGGACTTCCTCTGC	TCGATGGTGGCCATGATGGTGTC
CCCAGGAAGAGGAGGTGAAAGCCAAAA	AAGCAAAGCAGGGAGACACCTTCAGAA
TCAGTCCAGCCCTGGAGGCAGGC	CAGAGCACACACCTCAGGGCCT
GGCCAGGCCAAGGACGAGCTGTAGAGA	TATCTTTGATTCTCCTTCAGCCCTCAC
AAAGCTGCACAGGGCCCTACGC	CGTTCACGTGACGTCCCCAGCGTT
AGACACAGACACACACAGGCCACCCA	GCAAGGGTGAGAGGAGGGGCAC
ATGTAAGCTCCACTCTCTCCAGGGAAG	GGGGTGGGAGGGAAAGGTATGG
TCTACCTGTGTCTTTGACCCCCTCCAA	GAGGTGGGAGGGGAGAGCGGGGCAGG
AAAGGGAATGGAGGGAAGGGGAGGAA	CAAAGGGAATAAAAGCCGGATAAAACC
ATCACACACGTTTCCTGGACCTCACTC	TGAGAGAGGGAGACACAGAGGGGTTTG
TACACAACTTCCTAAGCCACTCCAGCT	ATGAAAGAGAAAGGAGTGGTGAGGGA
TTGAGGGGCCCAAAGGATGTCAGCAG	TGGGTAGAGAAGAGGAGGACTTCAATT
GGACTCTCGGCTACTGCAGGTCAAAGA	CAACCTGAGGCAGTGCCCTGTGTGT
TAGCCAGCCCCTCCCACCCCCAGGGTCC	AAGAGGGGAAGGCAAAGGGGATTAA
ACAGGCCGGGGGATCTCGATGGACTT	CCAGGGGAGGCAGCGGCGTCAC
GGACGAGTGCAGCAAGTACGGGCTTGT	CGTATAGGTGTATGCCATCACTGAGTG
TCACTCCTCTGCCCATCGTCTTCAGAG	GGGAAAGGAGAGGCAGGTTTGTG
CCTCAGTCGCCGGCCGGGAGGCGA	AGCTCCGAGCCCCCGAGCTGGGTCA
TTGGCGGCCCGCGGCCGTGCTGCA	TGCTCCGCGAAGCCACGGCTGGGCGAC
AAGCTGGAGCGCGCCGTGAGCGAGAA	CCGTGAACAAGCGCGAGCCAGC
TTCGGTCTTTACCTGAATCGCTCAGG	AAAGGGGAAGACCACGGCGGGATCCAC
GCCCTCAGTACCTCCGGAGAGGACA	ATTCTCGCCTTCACTAAAGTTCCTTCC
ATAGTTGTGCTGCTGGTGGATGGGAAGG	GAGAGAAAGATGCTAGTTACTCTCATGTGA
TCCAGCGAGCTGATCCTCAAACGAT	CTGGAGCGCCAGCGCCGCAACGACCTT
GTTCAATTTTCTTTAGCAACTGCTGCTG	ATGTTGTGGTTTCTGCGACGCTCACTG
GCTGGAAAAGGAAAAATTGCAGGCAAG	GACCTTGGAGAGCCTGCATCCCAGGAT
TTTATCACTGTATCTGGTCCCCTCCAG	AGTGTCCCTGCTGGGAGCTCGGAGGAG
TGTCCCGTTCTTAAAGGAAGATGGCC	TTCTCCCCGGCGGCGGCGGCAGCTCCAC
TTGAGAGAGTGGGTGTGGTTCTGTGC	CCATGCCATTTTTACCTTATGTCTGCTA
TTCAGAGAAGCCTGCTGCCGTCAGTAT	TGTGCCCGTTGTTAAGCTCAGTGGC
ACTGGCCACTCCTCACTCACCCCATCT	TACACACTCAGGTATAGTAAGGTGGAA
CTGATAGACCTGTTGATCTTCTGTATCTGT	AGGAGCCAGGGCGAGACGGCGGCGTGGCCG
AGCAGAGAAACATTTTAAATCCTTCCA	ATTATCTAGAGAAAAGCCTGGCAGAGC
GCCTCTGCTTCTCCAGAAAATAACTTG	AAGTTCATACAAGTTCCTTCCCCGGT
GTCTAATATATGCACAGCAGCCAGTAG	TGCTGACATAGAGCTGTTGCAAACAG
CTTCCCAGCAAAATAATCAGCTCTCAT	TCTCTCGTAGTTGTATTTTCCATTTGT
ACTACGTGCTCCCTACGCGCATGCGT	GTTGGGCGCGATCGGGGCGCAG
CTGTATTTGCTAAGTCCAGAGCGCAAA	AAGAGGAACCTGCTGTCAAGTCCCTG
ACTCACGGACCAGGTATGGGTACTGC	AGTCAGTTTGTCCACAGACCTGTCC
GTTCCCATGCACCTGATGCCAGTTTCT	TGCTATCCCTAGGCCTGTCCAGACAAT
AACCTTCCCTCTCAACTTCTCATCAGC	TGTAATCCCAGAATGCTGCTGAAGT
GCTTCCTGTAATCTGTGGGTCTCTTTC	GTATCTCTTGCATCATTTTCCAGGCC
GGACCCAGCAGGCTGCCCAGGC	CAGCATCTACCCTGGAACTGACTTTT
CTCAATCTGCTCCTGGAGGGTGATGTT	AAGATGTCAGTACGCCGCTCAGCCAA
CCAAGCACTGGGTTTATAGGCTTAGAT	GGTGTAGAGGAAACAGCCATTGGTAAG
CCCACCAGTGTTCTTACTGAAACATCT	TGGGGGTTCCAGGAGAGCCCAT
TTAGCACATGGACGCTGGCTGGCAGA	AGGGCCTGCTTCCCAACCCTCGGG
GGGAAAAGGTCATCCTGCAGGC	CCAGAGGCAAAGGTATTCCTTATCAAAG
TGACTTTGATGAAAGCCCTGGAGGTGG	TCTGTGAGGAGTGACTCCAGATGGGGA
CTGAGGTTAAGTAACTTGCCCTAAGTC	AACTGAATAGCATTTCTTGCAACCAGT
AAGTAATCCAAGAGACCATCGTGCCC	CTGGGCAGGATGGGGCTGGGGT
TGAACTCAAACTCAGGAGGAGGCTCTT	TCTAAATCACAAGAGCATTGACTTCCC
ATTTGAAGCTAGGATCCGACAGAACG	CCCAGTGCCCCCTTCACTTACG
AGAAAGTTGAACTTGGGGTTGTTGATC	AGTGCCATCTGCCTCATTCAGCTTGAA
CCTAGAGGAGTTTTACAGTGGAGAACC	TACTTGGGTGGGTCAGAGGTGGGTTT
AAGTGCGCCAGTCGTACCTTCGCGGC	TCTCCCCCGCCCCTCAGCCTGCAGCCG
TAGCCATCTGGTGATGGGACTATGAAG	ACAAGTCCAAGAAGAGCAAGAAAGGG
TTGACTGAGCTGGTGGGGACTGGGGG	ACCCCGCCCCTCCCAGGGGACCTC
AGAACTTGCCGGTTAAGCAGGCCCCC	GCACAGGTGGCTGGGAGGGGGC
CAGTTTGAGCTCATGGTTGTTCTCTTG	TACTAGTTGGAAGCCATGGACCGACTA
GTTGAAGCTAAGTCCCTCCTCTGATTG	AGTATAGTAAAGTGTTTCCAAAGAGGG
GGCTGGGGGAGTATTTCCTTACTTATA	GTCTTCATTATTTAAATGGTCAAGTGCT
ATATCACTCATGTTTTAGACTGTCCAT	ACTTCTGTTTCATTTTTCCTTTTATGAGT
TCCAAGGACATACGGTAAGAAACCTTT	TTGCTTAGTAGGGAGAAATGGGTTGGC
GTTAATCATGACCACTTTAATGTGGAA	TCCAAGAGTTTTAGCTTTGAACCATTG
GCCTTGTGGTACTATTTGGGATAAAGT	AATTTCTTATAATTTACGTGAAAGCTGGA
GGTACACTTCTAGCAACTGGTTCCTATG	AAAGCTCATTAAGTTCTGTAAAGGCAA
TCTTTAGTCCATATTCTGGCAAACCCA	CACTGTGTGACACTAATGTTGTATGGG
GTTGCCTTGTTCTGATACGTGAGAATG	TTACTAGTATACCTAACCCTCAGAGCC
CCATCCACCATGTTGTAATACTGCCTA	TGTTTCTCAAAGTGATACTAAAATGACTT
TGCCTGATGTAGTACAAACAAGACAAC	AAACTTTTAATTCGGGGTACATGTGCA
TGCTGTGCAAGCTTATCTCTATAAGCT	TGAATTCATATAAGAAGTCCGGAGGGA
CTGTGTCATTTAGCATGTTGCCACTAG	CTTAAATATGCCGTTAAGTCAGCTGTC
GGGTTATATCCTGTGTTGTGACCTCA	TGTATGTTTTCTTAATGTCTGGACTGC
AGAGTCCGAGGGCCACCTGGAGTCTC	GTAGCTGCGATGGGATCCGAGC
CTTCTGCCTTTTCCGTGATCCATTCA	GCCAAGAAAAACAGAATCGTGTTGAGTA
TGGATGAAACGAATGAGAATAAGCAGA	AGGCCTAAAACACATGTTTCTTCACTG
AACAATGCAGACAGAGCCGATGGTAG	GAAGCATATCCAAAATCAGTAGTTGGA
GCATCATGATCAAAAGTGTGAAACGCG	AATCAGGGAGCTAGCTGTTCATAGTTC
GTTTCAGGACAGACTCTTCTGAAAGAG	GAATGAAAAGAAATGTGGCCCCTCAAA
AGTATTATTGGCATAACACATGAACAC	AGCAGCAATTAACTTCTCCATATTAAC
CAGTTCAGCGAGAGTTAATGATTCTGG	ATCCTTGTAGCCTCTTGCAATGAAAGC
TGGAAAAGGGGGTAATGTGTAATCCCC	TTAGAATGAAATAAGACAGAAAGAAACCAT
CAAGTTGAGTCCTTGCAGCTGTTACAA	CAAAGAAAAGACAACTAGTCAATCACC
TATGGTAGACAGAGCCTAAACATCCCC	AAAGGGAAGAAAACAAAAGCCCTGGC
CCATTTATCTCCTCAACAACCTTCCAC	CAATGGAAGAGAAATGTGGAATCACAA
GATTGCAAACCCTTATGACCCCATGAA	AAGCACATAAGAAAAGGTTAGAAAGAAG
CTACCATAAAGCAGAACTGGTCTGCAT	GGGAGAGATGAAACAAGTCATGACTGAA
ACTATGGCTCTAAAATGCTCTGTTCTC	GTGAGGAAGAGAGGATTTTTCTTAGCAA
GACACAGTTTGCAAAGCAGTGTTAATC	AGAAGCACAACAGAGTCAATAATGTTA
AAGTTTCATTGGTGTCCTGCTTCCTTG	CCCAGATGTTGAGGGTTTTCATAACAC
GCCCAATTTGCAACCTAAGATTAGGAG	CAAGACAAGGGCCATTTACTATCCCTC
CTATCCTGGAGTTGGATGCAAGTTGAA	GGAGAAAACAAGCCCATAGTCAATACAG
GGGAAATGCACTACTAGGCCAACAAAA	GAAAAAGAAATAAATTCTGTCTAAAGGGCA
GAGGGAACAAAAACTCTACCACCATTC	GAGAGTAGAGTGCAGTTACATTCTTAG
AGATAGGGATACTGGGCACTAAATTCG	GAAAGCAAGAATAGATTGTGGTGAGCA
GGGACCCTAGTTACAGGATGAATCAAA	GAAATCAGAGAACATTGATAGATGAAGTGA
GATCTGGACTGACAGTTTCTGGTCC	TTGACGACAGGGAGTACCACTCTCCCC
CAGATTGGTATAGTCCTGAGGGTGGGA	TGGGAGATAGGACAGAGGATGCCCAT
CAGTGTTGTCAAGTGGGACCCTTTAAA	AAGGGATCCCAGGGAGGGAAAAGGA
TGGCTAGGGACATCATGAATGACTCC	CACTGGGCCCACTCCAGGCAGA
CACTTACATTGCCCTTGACAATGTAGT	TGAACAACAGTTTTGGTCCTTTACCAC
TGGGTGGCTATGAGCCAGGGCCAGGTT	CCCTGGGACCTCCTCACCTTGCTCAGA
TCTTATCAGAAAGGGAGGTTCCAGTTG	CAGGCCCCATTTGCTTGATAACAAG
TCTCATGCTCCTGTTCATGGAGGGGAG	CCTGGCAAAGGACAAGAAAAAGGC
TCTCTGCATTTGGTCCCCATGTATCT	CTTGGGGTTCCTGGGGCCAAGG
TGCAGTTTGGTGAGATGGCAGCT	AGTGAGGGGAGGGGATGAGGGAAGGGA
CCCTGTGATAGGAAGCTGTGGAGTGAT	CAGGCAGTTCCTGGACCTTGTTTCTGA
CAGTCAACAAGCATTTATTGAGCACCC	GAGCGGAGTGGGGCTGCCAGGT
ACATGCTGGCGCTGGGAACCCTGAAG	AGAGGGAGCCTTCGCACCCGCACCGCC
CCTGGCAAAAGCAGAATGTGGCTCAGA	CCGTTGATGAATGTCCATATGACGCT
AGAAACCCAGGAGGCTGGAGAGCT	TCTGGCACCCTTTTGTGTGCTGCCT
CACATCGAAGGGTGAGCTCAAACGTCA	TTTTGGTAAAATATTCAGGGCCCAACG
CACTAATGCCAGATGCTTGTGTGTTCT	ACTTATCAGCTCCCGTCTACACAGCCC
CAAGTAGATTTCCAACATGCCGGCAA	CCACTCTCCAGGAGCTTTCCCTTA
CTGCACGTTGCTGGCCACGCAGGAGTA	CACTTGTAAAATGGGGCTAATACTGGC
GCAATATCTCTATCATGTTCAGGGAGC	AGTCCCTGCAGATCACAAGGTGAAGTC
TGTCTGCTCACAGACCCGGTGCTG	TGGGGCATGGGGACCGGCAGCCA
GCACACGCACCAGCGAGACGCCTGCTT	CTCAGAGAGGCTGATCATTCATCTGAG
TGAAGCCAGGAGCAACGGTGACCTTGC	AGTCTGAGCCTCCTCCCAAGAGGCCT
CATTCCACGCTGCCATTGCCCACACAT	TCATTTGCTCAGCTCCTAACCCTCAA
GGAGGAAGAGGAAAACAAGACAAACAG	GGGGGTGGGGGACTTTGTTGGG
CCGCACCCAGCCAATTTTGAGTATTTT	CACACTGACATGTTTTTGAGGAATTGA
TAAAACCATGAGGGGATGGACAGCTC	TTAGTTGCCATCAATCCAGGTGATCGC
CCTGAATTCATATAAGTCAGTTTTTCAGA	AGACCGGGGACACAGTGTAGTTGGTG
CCCCATCATCGACTTATCAGCTTGTTT	GTCCAAAGGTGCCATATGTTCACACT
GCTCAGTGGTAAGCTTAGGTACCTATT	TTGCCATCCAATTTAGCATACATAAAAT
CAATCTTGATAGAGGGAAACTGTCTAG	GGCAAGAATATTTTAACAATCCCACAC
AGGAATAGCAGACTCATATGGTTTGAT	TTGTTCCTAAAAGGACTTAAGGCACCT
AGCACATTACAATATAGGGGATGCAGT	AGCTAAATTTCCATGCCCTGCAATTTT
CTTAACAGGAGGTACACTCAGTGAAATT	CTGAACATGGAGGTTTGTTACGTAGGT
CACTATTAAACTTGTTCGAGAGTTTGC	AATGCACAAAAATGCTGAGACTTTGGT
AGTTCCACATGAGGGCGATTTGGATA	AAGTCACTGTTTTGTTAGAATACTCCT
GTTTTAGTTGCACCATCCTGAAAAATT	ATGGAGATAATTCACTTTGCAGAACAA
GGTTCAGGAGGATGCATGTCATAAATA	AAACAAACGTTTTCATATTATTTGTGTGT
ATTGAGCCTTCTAAATCATGAATGTGG	AGACTATGTATCATTTTTGAGATGGGC
AGCAATAGATCCTTTACTGAAGAATGC	TCTTTAACATTGACAGTTTAGTTCTTGC
TCCCCACTTTCTAAATAACAAATGATCT	GAAAATGTAAATAAGGTATCGATTAAGCCG
TCTCTTATGGCAGGTATGGGATGGCAC	TGGTTACATGTATAGGTGATACAGTCT
GACTCTCCAAGATGGAAATGGTGTCCT	GGAGAAAAAGAGTCACACTGCCATAAG
CCTCGCACTTCAAGCAAGTATTTTAAC	AATACTGGGAATTATAAGTTAGCACCA
CTACCATTTTGTGGTCCTCAGTAGTGA	ATTTTGCCAGCATAATTAAGAGAGGGC
TGTGGACCAGACAAATGTAAAACTAAC	TGACAGCAAGCTTTTCAGGAGATAAGA
TTCATAGTTTCCACTAAAGAGCAGGCA	TCTTGGCTTTCAATACACACTGCAAAA
AGTTACATGGATTTGCTGCTAATATGA	TTTTTGGAGTGGAAATGCATTATTGAT
AGCTTAGACAACTTTGCACATTTCACT	TTAGAGTATTACACCTATACCTGTATATGC
TCCAATCATTTCTTGACCAGTGCTTAC	GATATCCGATAAAAATGTTGTTAAAAGAGC
TTTGCTGCTGCTCTCACCGCTGAGCG	AGACACGTCTAATAACTGGGTTTTACT
TCCTGGACGTTTTGGTGGGGTCTTTAT	CTTGTTTTGATATGCTTTTGATAGTCTGA
AAGAGCCTGAAGGAAAGTTGTATGAAG	AGACTTAGTGCCTAATTATTGCAGAGG
GGTTTTATTTCAGCGTGCTCTTGCTAAA	GAGCTAGAAGCATTATAGCTAGTGTTTGAT
CAAGCAAACTGATAGATTCAGCTCCAG	GGCAATCAGTGAATTCTTGCTCGTTAG
GTGATTGCTCAGCAGCATTAAGTACAG	ATTGCCGCTGTTGTCTCAGAGGAAAA
TCAGCCACTGTGTATTTTCATATTTAAAAT	AATTTTCATTCCAGATTTAGCAAAAACC
TACTGTTCAAAACTGTATGACCTATGT	AAGTAAGCAAATCTATCCATTAAGTCATTT
CCTTTGGAAGATAGAAATCAGTGGTGA	TGTTCTGTTGGAATAGTTCCTTGATGA
ATCTGGCACCGCCCACCAAGAAATTGA	TGCAACTGTATGGCACATTTTCTTTTT
TCTACTCCTCCTGTCTCTTTCCACATC	TGGACTGACTATATTCCCCTGCTTTTC
CTCCTCCCCATTTGTGGGATATATGTT	AGCATATGAACCTTTAGATTTATACAGCA
GTTTTTCCATTGATTGGCTGTTGTGGT	GCATTTCATGTTCAGTGATTCTGGGGAT
TGGATGATCGTGAGATAATGAGAGAAG	TGTGGGAATGATGGTTATTCCAGCATA
AACATGTCGTCATCCTCAAAAGCACTG	AATTACACACAGTTACAACACTGGGGC
CTTTTAAAGTGACATCGATGTGGCCC	TTTCATGTAATGCATTTTCATCAAGAAAA
ACTCTACTCTGATTCAAGCTGAACTGC	CAATCCAAGAATGTAAGTGATTTGGAA
GGAAGTTATACCTACTTATCTCCCTCT	AAAAATTGTTGACTTGGTCTGCAATAA
GATAAAAAGAAGACTATGAATGGCACG	TGTTAAACTTGTTTGGTTTTTGTTGTTG
TTTTTCCCCTCTTAGGTTTTCTTCTGT	GTTTGATGTTGACATTTTTATTCACTTTGT
GAACATTGTTCTGGCTGGCTATGAA	GACCCCAAAATACTAAGAGCTGAAAGT
CATCTTGACAAGTCACTTTACCCCGAT	TCTAAGCAGCTGCAAGGAGAGCCT
CTCCCGCTTTGTGTGCCCCGCT	CCACCCCGCCCCTGTCCCCTAG
CTCCACATACAGTCCTGGATGATGAT	CAGCAGCTCGAATTTCTTCCAGATATC
CCCGGACGACGAGACCTTCATCAAAAA	CCTCTCAACGACAGCAGCTCGCCCAA
CTGCCAATGAAAATGGGAAAGGTATCC	TAGGGGAAGACCACCGAGGGGTCGA
ACTGTCCAACTTGACCCTCTTGGCAG	GAAAGGAAATAGAAATCACTCCTTTAGC
TCCCTCCACTCGGAAGGACTATCCT	GAAAAGGCCCCCAAGGTAGTTATCCTTA
GGTGATTGCTCAGGACATTTCTGTTAG	TTGTTTTCCAACTCCGGGATCTGGTCA
TCCAATGTCACATGAATGTAAATCAAG	ATCACTTCAAAATACACTGAAAGTATGAA
TGCACGACGCTGCCCGGGAGGGCTTC	GGACTGATGATCTGAGAATTTGTACCC
CCCGGTGCAGCACCACCAGCGTGTCCA	CAAGCCCCAGGTGTCTAATTACCCCTA
TGAACTCTTCTAATTGTAATGGACGTG	ACTAGTGAAGAACTGAAGGAGTCCTGC
GCTCCTTGAAAATACAGGTAGTAAATG	CAGTTTAAGTTTAGCTTTGTGTTAGCTTAT
AGTACCGGTAGTAATTACAACGGCAAA	CTTTAATACTACCAGGAACATTTTATCACT
GACTTTATTGAGCTTTGTTCCCCTCGA	GAGTATCATAGTTGTTCGTGTGTATATCA
CTTCCCCCATCTATGAATTATTAACCTG	AGTGTGTTGGGTATGTGAGGGTTGTC
CTTGTCTACCACTAAGTGCAGCCTCTT	ATCATAATCTCTTCTAGATGGAGGCATGG
CAGTCTGTAAGTTTGTTCCATCTCTGT	ATATGAGCCCTCGTCGAGGACCACCTC
TGCAATTTTCACTGAACCTAGGAAAGC	CTTCAGAACACTTTTTGTTTACATTTGAT
TCAGGTTGCTCACTGCAACAGTATATT	AATTCTGCCGTATTCTTTGCTGG
TCGTCTTAATGTTGAATAAAGCAGTTTC	ATGTCATAGTGCCATTGAACCCCACT
CATGTGTTACATCTCTGTGAAAGTTTG	AGTATGTTGTATTGGGGTATGATGGGG
TTGCCCATGTACTGGATCGACTTACC	ATGTCCCAACAGTTTATGCCTCACTG
CCTGGTCGTTTTTACAACCCCAAATAG	TTAAGAGTTTAAACTACTACACGAGCA
CATAACGTTCAAGTCTGTAGCAATGCC	AAATTTTATTCTTGAAAATTTGAAGGTGGT
TTCCAATAAGCCAAATGTACTAGCTGC	GCCTTAGGAGTGTGTGGTGAATTTTTG
TTTCATGTAATTGCAATGTTACCCAAA	TCTTAGCTTCTTCATCTTCCAACAAAT
CAGCCCGTTTAAAACAAATCAAGAAAC	CCTCTTCTGGAAAGGGGTACCTATTAT
CTTGAAGGCCTAAGATGAATGCATGAG	TTCAAGATCTTCCAGAACGGTCAGCGA
GAAGAGAAGAGAAGAGGGAAGAAAGAAAA	CCAGCACGTCGGGGGCCGGAAC
GATTTCTATCTCCTGCAACCACCACTA	AAAAAGAAAAAGGAAGAGAAAATTGGGA
TCTCACTCTCACGCACCAAGAAGCTGC	GAGAAGAAAGGAACCAAATCAGACATATCA
GAGTATCTGCTGAGCAGCGGGATCAAT	TTGCAAGAAAGCTCAACCAAGAAGATG
TACACCTCCCCGTACTGGCCCCCGCCCAG	AAGGAAACAGGGAACAGCCTTCAGCCC
ACGCACGGACATCACCATGAAGCACAA	TTTCCGTCTTATATCATTCCTGTGTCT
GCAGAGCACAAATATTCCAACGAGGTT	AAAACGAAGGTGAAATTATTTCAGGAA
TGTGACTCCATGGCGCAGGCTGCCTGG	CCAACAAGACAACGAGGACTTCAAC
AAAAACCCTCCTGTAGTCAGGAAGGA	AGAAAGGAAAATGTTCACCCATGAGAG
GTACACACTCCTGCACAGTTGAATTTC	GAAAGAAAACCGAAAGAGAAAGGCTGTT
AGAAAGCACAATACTCCACACCTCTG	GGACAGATGAAACCCAAGTCAGATCA
TATGATGGCCTGAATGTAGCCTCTGG	AGAATCATACAGGGACAGAAACAAAAA
CTGAACAAGTTGGTCTTTTTGTCTTTGG	AGAGTGCCACTGCTGCACTCCAG
GGCCTGAATGAAGATGAGCGCCTTCT	CCTTGGACACAGCTGACCCAGCCAAGT
AAGAGCGCAGGAAGCGCTTGCTGGAGC	GTGAAAGCCAGTGCCCCGTTGC
CCAGCACGCTGACCAGCAGCCGCCTA	TGAGAAGCCGGCTCTGCCTCGGAAGA
TGACCTGCCGCCGGAGGGGTTTTGGAG	TTTTGTGCCCTCCAAATGTGGACGAGT
CCAGCCCGGGCTCCAGCCCGCCCAACCT	GAGGAGTCCAGAGTGAGGAGGCACAA
AGGACTGCCTCCCCGGCCGCCTCCTGG	ACCTGAGCCTGCTTTGCTGGTG
CCCCCACCAGCAGCCTCTGCAGGGAA	GTCCGCCAAGCCGTCGGGGACCCCCAT
ATCCGCTCTGGAGGCTGGCGGGTTT	TTTTTGAGGCCCTCTCCCGGCTGGCTGGGC
CTTCCACCGCCTTCATCCCTCTCATAT	GTTCTGCGTGAGCTATGTGGATTCCAT
TGCTGCTACCTCTGCACTATGTCACT	TGTAGAGGTTTTTGCCGGCCTCCAGCA
CAAGCTCCTCAGTTCGGTGAAGGAAAT	AGTCCAGCTCTACTACCTACGTTTGCA
TCAAGGCACGGAGGAAGAAGTCC	TGGGTGGGGGCGGCCGGCTGGCCTT
CAGCAGGCAGCCCTTGCCGTCCT	GATGTCGTGATGCATGCGCTCCTGT
TTGTACTGCTGCTTCCTCTGGTGATGG	TGAGGCTGCTGGACGAGTACAACCT
TCAGTGTCCTGCGGCAGCATCCCTGG	CCCCATCCCGGGAACAGGCTCT
AACGTGGTCTTCAAGCGTGACGCACAC	TGAGTGAGACCCGGCGCCCACGGTCA
TAGTAGGGGAAGATCATCTGCTGGC	CCCGTCGCTGAAGTGGTCCTTGCAGTA
TGAACTTGGATGTGGCCTGGCTTGGG	ACTGCGACCAGGGCTGCAACAGCGC
AACCTGATCCTCTCCTCGCTTGCCTGA	ACCGCCCCGCCCCTCCAGGTCTGGC
CTAAATAACTACTTGGGGGCAGAAGTC	GGAAGATTAAGACATATACACGACGATCAG
GACCTATTTGGTACAAGATTTTATACAGAA	AAATGTTTTATTAAACTGAGTGCTGCA
CCCAAGATAGGCAACTCTTCATGAGAG	TGATGTAATCAGATAAAAGAAATGGGCA
AGGGAACTCTGGTGTTATGTCTAAACT	AAGGGGAAGAAAAAGTAACTTTGTTTC
CCACAGGGGTCATGAATACCATTTGTA	AAATGGTGCAAACACAGGACTAATAAA
GCAGATGTCTGATGACGGACATTTGAA	GAAAATAACCATGACTTTACTGGTGGA
GAACTGAATCACTTTCCCCACGTTCTT	GCGTATGAAAGAAAAGCTTAAATTCACTAG
CTTCTATGAGGATGTGTTGCCCGAGTT	ACCTTGTTGCCAATGTCACGTCAATAC
CAGTGGAAAAATCCCAGACATCAACAG	CCAGGCTAACATTCCCCAAAGTAGTTA
CCTCACCACTTGAAAATACTGGGTTTC	AACCAAAAATCAAATGATATGCTTTACAG
CCCCATTTCTTTTGTAGGAGTGGTCTG	CAATGGCACAGTGATGAAACAGCAC
GCTGCGGGGAAGGAGAAACCCTAGT	GTCCCGAAGTCGTGGCAGGAGGA
TTTAAATAGAATTCCAGGCTACACAGG	TAGAGGAACTTTGGCTCCGGCTGCGGC
GACAAAAGGCAGCCTACCATCTTATTT	TGATTTAAGCAGAAGAGGACTGGTGAA
CACCATTGCAGAGGCAGAATTTTATCG	AAGCTGGACCCACCATGTACAGTGTG
AGAGAACAAGAGACTTGCAGAAACCTG	TATTAACTACCAACCCAAGTGGACCAG
GTGGACATCTTGCTGTAGTTTACTGAT	GGCTGTCATGTGATTGAAAACTAGCT
TAATGGAGGGCAAATAAGAGAGGAAGG	CAAACAGAGCTGCCATAGAAGTCCCAA
GCTGAGAAAGAGGAAGACAGGAAATGA	GGTAAGCTGCATTGTTTGCTCTAGTTC
GCCTGTTGCTTTTAAAGGAGACAACTG	GACAAAGTTCAAGAAATGGTCTTATTCA
CCTTACAAGGTCATTGTGCAGTGATCT	AGTGATGTGTCTTGTTCTCAGCCTG
AGATTCAGAAAGCGGCCGGAGCCCA	TGTCCCTGTGGGCGCTCCCTGGGGCTG
TTGGCTGGTGACAGATCATAGTCCGAA	TGGGGGAAGGGATTTCATTCTTACTAG
GCCAAACAGCAGAAAATTAAAGAAAACCA	TCTTGACCCCGGCTTCCCTCTGGGG
TTCGTCTGCACACAGCACATCTGTCTT	GGAAGAAAAGCCCATTGTTAACACTGA
AAAAACAACGCCACTTGCTGCAC	GGGCCACCCCTTGAGTGTTCAC
ACACCTGCTGCTCCCATCGTTCTCTAA	CAAACTGTCTTACGCATCACTAATGGG
TGATCCCTTTGAAGCCCCAGAGGACA	TGTCTGCTTCGCCCGCCTGCCGGGGG
ACAAAGTACTTCTCCACAGGAAGATCT	AACCCTCAGAAACAGAACTTTCCAGAG
CCGTTCTCTTTCTAGCGTGCAATGAT	AGTAAACCTGAGCAGTTTGCTTGTG
TTCTTTCATCTCCAACTCTGAGAAGCG	ACACATTCTTTATTCATAAAGTCATGTGT
AAGCCAAATTGTTTTGCAATGTTAAGA	GGCCATGGTCGTCTTTATTCATTGTGT
AATCGCCAACTCAGCGGGTTACGTGGG	GCAGATTTGGTGAATGAAGCTTGTGGT
ATACAGTTCGGTAGTGACACATTTGAATC	TCCTCTTGGGTTTTACCAAAAGTTACAGC
CAGTGACTTCCACGAAACTTATACTTTCAA	ACCAAGTGTGGATGTGACCCCC
TCTCTTTGTTGGTACCTGCCAGAACA	GCTGGGTTTGGACACGTTTGTGTCAGTTT
ATCGGTTTTCCGAGATTTTGGAAACTA	AGAGAGTGTTGGCCAGAGCGCTGAGC
GGTTCGGCTTTAGGTTCTTGTCGGT	CCCCAGGGCATCTTGGTAGGTCACAAA
TTGCTGTAAGTCCCCTCTCCTTACATG	CACACGCCCATAGAGATTACTAAAGAGG
AGGAAACAGACTGCCATTGGGTAACA	AAACTCGGTTCTGGGTTGCTGGCTTT
ATCACCCGCCCCCAATGCCAATGCAG	GCTCTATATTTCTGTCTCCAAATGAGGCA
GCTGAATAACGGATGGTGTGGTTTCT	CCTTGTTTTTCAGCGACATGCTTTTGC
TTAGTGCTCTCCGGAAGTGAGATTCCGAA	AGTTCATCATGCCCGCGCATGGGCGGC
GCTGATGATTTCAGATCTATAGATAGCAC	TGTGACGTCTTTGGTAACGGTCTGCTT
ATACATGACAGTTAGCAGCGAGTTCCCCG	AGACTTGTCTTCTAAAGTGGTGGATGT
CACCTTCGCCCCCTTCCGGAGCCTT	GGGGCAACAGGAGAGCTGTGTC
TCTCGTCCATTGCGCAGACAAAAG	TTCCCACCCAGCCTGCTGCAGACACC
TGGGAATCAACAGGATTCCCAGG	AGAATACAGCGGCTGGGCCAAGCTGTA
ACAGGCCTGCCAGCGACAAACAGA	AGTCTGCACCAATGGGGAGCGCTTTC
TAACTAGCACCATTGATGTTGAGAGGG	ATTTCTTTCCGAAGAAAACCCAAGGCC
TGCCTTGAAGGAGTATCCCAGTAACA	CAGAGATGCAGTTCAAACCGAATACAC
GACTTTCAATATGGGCCATTGACAGCT	AGAGATTAATAGCTTCTGTTGATGCCA
CCTTCCCCATCTGCATCCTTTATGAAT	AATGCGCCCATCTGGGCCGGGCCTGAG
ATATCCTCTCACACCCAGAGAGAACCA	TTTTTGCCCTCCCGCCCTGTCTGGATCCCT
TCTCCTCTCAACCTCTCTTTTCCCCAC	GGCCTGGCTCAGGAGCCAGTCC
TTTGTTGATGTCTTGGCTTTCAGGGGC	GTGCAAAGAAAGTGGGGCCTGG
TAGGCTTCCTGTCCCTATCTCCATCC	TGATCCCCTAGGGCAGTTGACGAAGAG
AGATGGGTCAGGATCTGTATCTGAGAC	CTCCTTCTTGATCTGTTCGAATGCCT
CCTGTTTCTTGCTCTGCATTGTATCCA	GCTTTGACCGCTTCAATGCTTGTTTTG
AGGCCACACTCAGTCAGTCATCTTTC	AGATTTACCCTTCTACTTGGGCCTACG
CAAGGTGCTTTCTCAAAGATTGAAGGC	ATCAACCACAGGGGTGTGGTGGGGGT
ACGTAGATAGAGCAGGCAGCCTGC	AGTATTGTGGCTGGTGGTGGGAGTGGG
TCCAGGGGCTAGGTGAGACCCAAATCT	AACAGGACAATAGGTGAAGACTTTCCC
TGTACATTGGTTATCTCTGGCTGATGA	AGGAAGGAAAGAATTAAAAGACAGACT
GGGAAATGAAAGACTTGAAGGAGAAGAT	AGGTGGGAGGATTGGTAGAAGAGATT
CATGGCCCACACCCTACCAACCTGGTT	CAACTGAGAGAACCTGGCTTAGCACTA
TAAGCCACAGGCAGTGCTGTTTTTAG	GGCCTGGCCTTCAGCCCTGTTC
GGCTGACCTAGGCTTAGGACTCCCACT	AAATGAATCTCCAGTACTGAGCCTGTC
ATGAGAAACTCCGGGAGCTGAAGGGG	TTCAGCTTCTCCCCCTCTTCTCTCTTC
AGCGAATCACATCAATCACTAGCTTGG	TGTCTTCTCCGAGTCCACAATAATGG
AGATTCTAGTCTGTCCCCCTTTCCATA	GCCGGGACTGTATTCAGTATATCAAGG
TAACTCCTGTGTGCCCTCACTTTGTAG	AAGAGCAGAGAGGGAACTCATTTCCT
TAGCTTCTTCTGCTCTTCTAGGGACTG	TTCTCAATCCGCTTCTGATTCTCTTCA
CTATGTCTGCTTTTTAGTAGGCCTCCT	CTGGAGGAATACATCACCACTAGCAAG
AGATCCCTGGGCTGACATCTGCTGA	GGGCTATAGTTATAAGATTAGGGATGATGG
ACAGGGAAGGAGAACAGGGATGACCAA	TTCTGAGCATTCTGCAGAGACTTCTTG
CGCCCATGTTCTTTTAAGTAATTCCCT	CACTACAAGAAGCGTAAAGGTGACATG
AAGGATGAGGTAGTACGGGCTCAGGT	CAGACCTGGGCCTGCAACTTGT
ATGGTAAAGCTTAAAGAGCTGCAGCTG	TAATTAAACTGTGTGTCCTCTTCAGCC
AGTTGGTAACTTTTTCTGGGTGAAGGA	CATCGCAAGAAAAATATTGCGGCTGAA
TGTCATTGTAGGTGGGTGAGGCTGGC	GGGCGTTTTTAACAGTTATTGGCTATCT
CCTCCCAGGACCCAAGGAGAGCTTTCT	TGACTTACCTAAGGGAAGAGGGACGA
GCTTCTGGCTGCTATATAGTAACTGCA	ATCTCATGGATGCCATCAGCTTTGTGC
TTACTTGACCCCCTCCGGAGAATGTGG	TTGCCTCGAACTCGCCCTTTTCCTAC
TTAGGCCTGGACGTATTCTCGCGACAT	AGATAAACCTGGCCGCGGCCCTGCGCA
ACAGAGCCTTGATGAGTGCTGATATAA	CTTTATCATCTTCTGGAACACCTCAATG
ACTCAGAAGGCTTACCATACCAATCAG	GTGACAGAAAGATAAGAATTAAAACCCTTC
GTACAAATGAACTGGGAAGAACAACAT	AAAAATACGAGGTGGTTAAGTTATATCAC
GACTTTCTCTCTTACTTTGTCCTTTGC	CTATCCAATCATCTACCACCGACTACA
GGCCTCTGAAAGTGTGGGATTACAG	AATTTGCAAATGTCAGAAGTTAATATATGG
GTGCTTGTATGTCGAAATGCTCTGACT	TTAAAACAGCAATTTCATTTAGAATGCAT
CACTTCTTACAGGATTGTCTGACTCAC	TCCTGGAAATGGGATGATAATTTCAGT
CCTAATTAATGGTGACCAAGTTGGTCA	AGTAAAAGTATGGTGAAACTAATCTAACAG
AATAACTTGCCCAGAGTGACTCAGTGG	AACACATCATTTCTTTTCAATTGTAAAGG
GGAGATAACTCATGAATGAGAGGTGCA	GAATGGGGGAAGGAAAAACGATGCAT
AGTAATACTAACCTTGAACCGACTGGT	TTTAAATGTTTCATACCATAGCATTCCTT
AGAGCTTAATTCCAAACTGGAACTTTT	TTGTTGCATATTTGCACTAATGTTCAG
ATGTGAAAGCTTCGATATGATCTGTAG	AGAAATAAGCAGTAACAGGTGCTTTTA
TCAACTAACCTCACTTTCTAGAAAGAAAA	ACAAAGGAGTAAAGGAGAACTGGGTAG
ATGATGAAAAGAAGAGGAAGACAAGGTCC	CCCACTCCCCCACTCCCCCAATTTTT
TGCACGAAGTAAGATTTTTCTATCAAAT	AAATTTAAAAAGAGCAATGTGGTCTTAGA
ACAAAATTGTTTCATGGCTAAAATGGA	AAAAGTCAGAAAGAGTTAGCTTATTTCTT
GCATCTACAGAGTACTGTGAAATATAAAGA	AGGAACAGAAAGACTTCTGTATTTATTAAG
TGCTTTCTTATTGTGATATTTTTAACGTG	AAGGAAACCTATAGCTTAGGTCTTCTG
TATACCTCTTGCAGAAAATCTTCAAGA	TTTCATCAAAACTAAGGCATATATGATAGG
ATGAATTGGCAGATAAATTTAACCGGC	AATCTGTGACTCAGAGAAGGTGAAAGC
TTGGACTTGACTGTTAACAGAATGCAG	ATACATTAAGAACCATCAAAGTGAAAACT
GGGGGCATTTTAAAGTTTACTGCATTT	TGCCTGAGCAGGTTTTTATTTATTTGC
CACTACTGAACCACCACAAACCTTTG	GTCTCCATTTTCGATTCCAGTTTTCAA
CTTGCTAAGATAACTGAAAGCAGCTCT	GAAGGTGGCATAATCTGTGGTTTTCTG
AGGTTGCTTACAAAAAGATTACCATCT	AGCTTTATTAACTCTACTTCTGCATTTG
GATGGCAATAAAATTACCTGCACTATTA	AAAAAGAGGAAAGCATGCTATAATCCA
ATGTCTTCATTGAACAGGATGATGATA	AGAGTATAGGCTTTCAAGTCAGATCGC
CCCTTAAAGAATTCAATGGCAGCCATG	GGAGAAAAAGTCCCAAACATTAAGCATC
CACACTTTGCCCAATTTCAACTGCTAC	AGAGCTTTATCTCTTAAAACTACTTGACA
AGTTATTCCAAATGAAAGGGCTAGATT	TGGAAAGAAAGAAAGCATGTTAAAGTT
TGAAATTAAATAGGACATTTCCAGCAAA	CTCACTACTTCCTTTGCCAAGCTTTTA
ATCCTTACTGAGTGAAAGCTGCATGC	GAAAAGAAATCGAAACTGTTAGCTTTG
TCTACAGGAAAACGGAAAGTGGTTGAG	CTCAGTTCTCACAACTTTTTGGGTACA
TACTTATAATCAAGAGGTGTTTGATGATG	GGAAAAGAAAATTAACGACGAGGTTTAGTC
CATGAGTGTTTATCCAATGCAGACTGA	ATCTTCAGCATGCCATGTAAGTGAGAG
CCAACAGATCAACCTAAGATTGGTCCT	AGTTCGCAGTTTAACATAGCTCATTGC
TGCAAAACTTACTTCTCTTGGTAAGTA	TAAAACAAAGTCAAGATCTGAACTAATGT
GCCTCTTTTTCTCACATCCAGCTGTTT	AAAAAGGAAATAAGTTGACATTAGTTTAGC
CGTTTATTCAGGCAAACAAAACTGCCC	ATGAGAGAGAGAGAGGGGAGAAAATCT
CCTATTGTATGCAGCTATCCCTCTGGT	GGGGAAAAGAATTCCAGAAAATCAAAACTC
CAATTTGTGTCCCACCAATACCAACTC	CATGGAAGATACAACCAGAGAAGGGA
CCTGGTTGGTCGAGTTGCAGAGAAGA	GACAAGCCTGACGATCCCCAGCCAAAAAT
ATTTGGGTGTTGAGTGGAGTCCAGGAGC	TTTCTGTAGCACTGCCATCTGGGTCTGCCC
CGGGCTCAAGCTTCCCGCATCTGACA	ACCCTGCCCCTGGTTACCACTAACTT
AAGTGGCAACTTGGACTGGAACAAGCC	GAGTTGCCAAAATGAAAGTATTCTTCTCTC
TCCGTCCCTGCCCCAGTCCCCCATTCA	GCCCGGTTCCCTTGTCGGCTCCA
AGTGGGCATGGGCACAGACGGAGGGG	TGAAGGGGGAGCAGAAGCTGGCACAGG
CGTCCCCACTCCGGTTCTGGCTCCCAT	GCCACGCCAGCTGCCATTCCCACCTCT
ACACTGAGTGGCTGCCCACAGCTTGGA	ATGGGTGTAGGGGCTGGAGTAAAGATG
GCTGACCCCGAGCCAGCCGCTGGTATATAT	GGCCCGGCCTCTGACTTCGGATTCCAA
TGTGGAGTTGGAAGCACCTTGGCAG	AGCTCGGGGGAGGCTAGCACGCCTGGG
CTGGGCCTTTGGCAGATACCTCCCTTGTTA	GCCTCTCCACCTGAGTGCAGCGAGAT
CGCTGAGACCTAGACAGGACTGT	TAAGAGGAGAGAAGGTAACGGAAGTCCCT
GCACACCAGCAGCAAGGCCCTCCTCT	GTGGGAGTGGCCAACCCAGTGCCTGCAT
TTTCACTGTGCTTGGCTGTCCCTCAGCACC	TAGGTGCCAGGAATGGTGCTGATCAGT
CAAGGAGAGCCTAAGGGCACTGGT	CTACCAGCACCCAGGTCCTGCCTGTT
TTCGCTGGAGCTGAGAGATGGCACAC	TAAATATTTGCCGGCCCCGTGGGTTTCCAC
CCCACCAGCGTTGTTTCGGAGTTTTCT	CCTCAGACTGGGACCCTGGCACTGTCT
ATGGGACATGTAGGTGGCCAGCACTT	TGAGGGTCAAGAGGACAGGATTGACT
GAAGCTGGCAGGAGACACGAAGCCTAA	ATGTGGTCTTCAATTTAGCCACCTGC
TTGGCTTGTGGCTGGAGCTGCTGCT	ACCATCCACCTTCTCCATTTTCACTCG
AAGTGCGGCAAAGAGAAGGACAGTGAA	GAACGGATTGGAAGGCTTTTGTAAAAG
TCACCACTGTGCCCTGGGGATCCCTC	AGAGGTAGAGGGTCAGGTCTGAGGTC
CACAGTGAATCAAATTCCCAACTCGAC	GAGTGATGTGTGGTTTGGGGACA
ATTTCTCGGGCTCGCCACAGGTGC	TGGATGGGATGTACAGAGGATGGTC
AAGTCTCTGCTGAGCCAGGGCCGAA	CAGCGGCGGAAAGGGAGAGCAGGTAA
CCAATCCGAACTCATTCAATGTCAACC	TCGTCTTCTTGCTCTGTCAGGTACT
CTTGGTCTTGCACTTTCGTTTTCCTGA	GAAGGCAAGAAACAGGAAAAGAACGG
AGCCTGCCTTGAAAATTCAGAAAAGCC	GGTGGATTTGAAGAATGGGAACTAAAG
TTACCTTATAGCCAAGACGCGCCGCC	AAAGCAGAGATGCAGTCCTAGGTCAG
AATGCTGGTGAGACCCTCCTGCAGA	TGCAAACTTGCTTGAATGTCAATTTGG
AAGGTCTTTTGAGTGAGAGGCTGAGCT	TGGGGACAGGGACAACTCCATGA
GATGTCCTCACAAGTTCAGGAATCAGA	TGGAGGTGATACAGGGTGAGGATAACA
GTTTCGACAAATGACTTCTGAGTCTGC	ATGAAAGAAGAGCAGGCAGTGAGAC
TGGAGAACTCCACCTTCCTACTGAGTG	TAAGGGGAGCATATAGGGGATTAGGAC
TAGGTCTGGCTCGTACCGCACCAGCTC	GCAAAGGCAAGGATGGGAGTTATTGA
CCCCCAGGCTCCTCTGAGACTGT	GCCAGCATTAGCGACTGGACTGTTTTT
AGCCCCACAAGCCCAGGGCCAGGG	CTTCCTGGGGTTCCCTTCTTGG
AGTGGAGTCACAGCGGAGATAGT	TGAGCTTGGTGATGGGTGGCGT
GAGGAACATACTAGTGCTTTGCAAGTG	AGTGCTGGAGGAGGATGAAAAGAAGCC
ATGTCTGAGAGTCCCAGCCCCCAGCTT	AAATGAGATGGGGATGTCGGCCCAGG
GTGCAGCTGCCCTTAGTGCAGAGAGAA	GTGTAGCTCCGACCCCTCTGCAGTGA
TGCCAGCCAGGCTGGGGCCACCAA	TCATCCTGGGCCTGTTCGGCCTCCTGC
AGGTCATCAGGGTGAGGACTGTACT	TCACAGAAGGACTGGTTCTGAGCGTT
TTAGAGTGTAAGGAGCCGCGGCGAGTC	AGAGCGGTCACCAAGGAGATCCAGG
CCTAGTTCTTACTAAGCACAAGCTCAG	TAAATGACCAGGACAGGTAACTGGTG
GGAGAGTGGAGGATTTAAGCCTGATTG	AGAATAAATCACATATCAGTCCAGCTG
CTCTAGAAGCAACACCTGACTTTAGAG	GCATGGAAAAGGAAGAAATGACTCAGG
