AAGGCCTGCTGAAAATGACTGA	TTACTGGTGCAGGACCATTCTTT
GCACCACTTTTGGAGGGAGATTT	CTTCAGCTGACCTAGTTCCAATCTTT
CTGTTTTCCTTTACTTACTACACCTCAGA	TTGTGGATGGTAAGAATTGAGGCTATTT
TCACTCGATAATCTGGATGACTCATT	AATGTCTTTCAGCACAACTAAAAGAAAAGTT
TGGAGAAAAGTATCGGTTGGCTTT	TCTATACTGCAAATGCTATCGATTTCTT
GACACAAAACAGGCTCAGGACTTA	GATCTGTTTTCTGCAAAATCATAACTGT
TGAGTCAGGAAACATTTTCAGACCTATG	ACTTCCTGAAAACAACGTTCTGGT
GGATCTTTTCTTCACGGTTGCC	GAAGAAGTTGATGGAGGGGGT
CTGAGGTTCAGAGCCATGGAC	TGACAGAGAGAGAAGGAAGACG
ATCATCTTCATAGTCATCTTCTTGACAC	AACTTGAGGTGTTTATCATCAGTGCT
AAATATACAGCTTGCAAGGACTCTG	TTCCTTCAAGATCCTCAAGAGAGCT
CCTGTATACGCCTTCAAGTCTTTCT	TGAAATATGCAGCAATCAAACTAAAAGAATACT
ACGGTCTTCAGAGAAGCCATTATC	TTCATGGCCCAGAAATTTCCAACT
GTATCCTGTTCCTCCCAGTTTAAGATTT	GTTCATCCTGCTGGAGCTCAT
ATCAGAGTCAGTGGTGTCAGAATATCTA	GAAGTACAGCTTCACCTAGAGAAAGAAAAT
CAGACCCTCTCACTCATGTGATG	CTCAGACTGACATTCTCCACTTCTTG
GCAGTGTACCGCCGGAAG	ATCAGTGACCTGAAGGAGGTG
GAAACTAAAAATCCTTTGCAGGACTGT	TATTTCTGGCTGCCAAGTCTCTG
AGAGACATTGCTGCCAGAAACT	TCAAGAATGGGGTGTGGCTG
TCCTAGCCCCTTGTGGACATAG	CATAAGCTGTGTCACCAG
CTGACCTAAAGCCACCTCCTTAC	GTGTTTTCACCAGTACGTTCCTG
CTGCAAGGACCACTTCAGC	AACAGCTCCTTCCAC
AGTGAAGGAGGATGAGCCTGA	AGATCACGGTGGACACACTG
CAGACTTCCTGAAAACAACGTTCTG	TCCCAAGCAATGGATGATTTGATG
GCCTTGGAACTCAAGGATGCC	TTCCATTCTCATCCTGCCTTCATG
ATGGAAGGATGAGAATTTCAAGCACTTA	TGACTGGGAATAGTTACTCCCTGG
TGGCATGGCAGAAATAATACATTCTTCT	CCCATTGTCATTTTCCTGAACTGG
CCAAAAAGGTGACATGGAAAGCC	TCATACATGGGTTTCTGTGGG
GCTCGCCAATTAACCCTGATTACT	TGATCCCACCATAGAGGTGAGG
TTTCTCCCTTCTCAGGATTCCTACA	AGTACATGAGGACTGGGGAGG
ACAACCCACTGAGGTATATGTATAGGT	TTTCTGTAGTTGGGCTTACACTTCG
TGTCCTTATTTTGGATATTTCTCCCAATG	TACATGAACTTGTCTTCCCGTCG
GGCAGGAGACCCTGTAGGAG	ACTATAGAGGTGAGCCTGG
CTCTGTCTCCTTCCTCTTCCTACA	ATGACGGAGGTTGTGAGGCG
TCCTATCCTGAGTAGTGGTAATCTACTG	TAAGCAAGCAGGACAAGAAGCG
CTGAAGACCCAGGTCCAGATG	AAACCTACCAGGGCAGCTACG
CGGTAGTCTACAGATTCATTTGAAACCA	AGAGAGAAAGAAAGAGCTTGTTAAAGACG
GGTAGCTATAATAATACACATAGCGCCTC	TAAATTGCTATGGTAACTGGGTCGTAG
TGTAACCTCCACCCCAAGAGA	CTCTAGGAAGGAGGGGTAAA
TGCTCTTTTCACCCATCTACAGTC	AAGCTCCCAGAATGCCAGAG
TGAGGATCCTGGCTCCTTATCTC	GTGTTCCCGGACATAGTCCAG
TCCCCCTCCTCTGTTGCT	AGCAGGGCTCACTCCAG
CCCTCTGAACTGCAGCATTTACT	TTGTCCAGGGCTATCTGGAAG
GTGGGAGACCTTGAACACCA	TTCTTCTGCAAGGCCT
CAGTTATCTTTTCAGTTCAATGCATGCT	TTTCGAATGTATGCAATGTCATCAAAAG
ATAAATTCTCAGATCCAGGAAGAGGAAAG	ATCATTACACCAGTTCGTCCCTTTC
CTCTTTCTTTGGCTTCTCTGGGT	TGAAGAACAGAAAAGCCATGAATTG
GTAACGGCTGAGGGAACTCAAA	TCACAGGAAATGCCTTTAACTGTC
CATCTACAAGCAGTCACAGCAC	TTCCTCACTGATTGCTCTTAGGTC
ATTTTAGAAAGGGACAACAGTTAAGCT	AAAAGCCGAAGGTCACAAAGTC
AGACAGAGCCTAAACATCCCCTTAA	CCATTGTGCTTGAATGCACTAGAATC
ATCCCATAGGACCAGACGTCA	AGATATTCTTATAGATGCTGCTG
CAAGGGTGGTTGGGAGTAGATG	ACGGAACAGCTTTGAGGTGC
TATTTTCATGGTGTTTTATCCCTCTTGA	CTGGTGTTACAGAAGTTGAACTGC
GTGGTAGCAGTGGATGCAGAA	GGGTACAGGCTGCGT
GGAAGGAAATTTGCGTGTGGAGTA	TTAAGGGTGGTTGTCAGTGGC
GTGACAGAAAGGTAAAGAGGAGCA	AAGAAAAAGGAGGAGAGAGATGGC
GGTACTGGGAGCCAATATTGTCTTT	TGGAGGGAGGGAGAGGC
TCTTTTCCTGCTCCACAGGAAG	CACTTTTCCTCTTGCAGCAGC
GTGCGTGGCTCTCACCA	TCTGTGGCGCGTAAGT
CTGCAGGATTCCTACCGGAAG	AACACCAAGTCTTTTGAGGAC
ACACCCCCAGGATTCTTACAGA	AAGGCTTCCTCTGTGTATTTGCC
CATCTTGGGCCTGTGTTATCTCC	AAGACTCCAGGTCAGGAGCC
AACATGCTGAGATCAGCCAAAT	TTGAGCTGTTCTTTGTCATTTT
GGCCATGCTGGACCTTCTG	CTCAAGGGCTCACATTTCCC
TCATCTTCTGTCCCTTCCCAGA	AATGCCTGGCCGTATCCC
CCATCCTCACCATCATCACACTG	ATCCACCTCTCATCACATCCC
CTTGGAAACTCCCATCTTGAGTCATAA	TACCAAAGTCCCAGTGCACC
CTTGGCTTGCGGACTCTGTA	GGTAAAGCCACAGAGAGACACC
TGGGTGGATGACAAAATGGACAAATA	AAGTCATGGTGGAGGCCTAC
CAGATAGCGATGGTGAGCAG	TTTGGATGACAGAAACACTTTT
AATCTATATACTTCCTTACCTGGGATTGGAA	ATACACATATGCACACACTCGATAGAC
GTTCAAGACAGAAGGGCCTGA	TAGGTGTGCGTCAGAAGCAC
GTCTAAGAGGCAGCCATAGGG	TGAGAGGGTATGGGAGACCAC
ACAAGCAGATAACTTTCACTTAATAGTTGTT	AGCCACCATTAACAAAAATGAGCTAAC
TGCCCCGATGTAATAAATATGCACAT	GATAAGTTCTAGCTGTGGTGGGTTA
ATATTCCTTGTCATTATCTGCACGC	TGGTATGAAGAATGTATTTACCCAAAAGTGA
GGACCCATTAGAACCAACTCCAT	TTGCATAGCACAAATTTTTGTTTCCTGA
TGGTTGTAGCTAACTAACTTCAGAACAC	TGAAAATGGTTCTATGACTTTGCCTGA
ATCTTTTTCTGTGGCTTAGAAATCTTTTC	AGGAAATCCCATAGCAATAATGTTTGGA
CAAACGTTCAGAATATTTCTTCGGAAGT	TTTTGCAAACAGGGAACTCTGTAGA
CTGAGAGGTATGAATGGCTGACA	CCAAACTTCTATCTTTTTCAGAACGAG
CCAAAATCTGTGATCTTGACATGCTG	AAGAAGCTCTGCATCCGAATTCA
GAGTGATGATTGGGAGATTCCTGAT	GTGGTGACATTGTGACAAGTCA
CCAGCACTTTGATCTTTTTGAATTCAGT	ACAGAGACAAGGGTCACCTCA
TGGTCAAGATCTTCACAAAAGGGTTT	ACAAGTAGGTAACTTTAGAAATGTTGCA
GAGCCCATCATCTGCAAAAACATC	TAGCCATCCTCTTGTCTCTGCA
TGCAGTTATGCCTCAGATTCACTTTTAT	CCTCTTATCAAGTGGAAAGTTTCCA
ATTTGACGGCTCCTCTACTGTTTT	GCAGATGAACATATTAATTTTTAAGCACTGTAA
GGCTGGCTTCCATGAGACTTC	TGACTCCTGTCCCAAAGTTGAA
GTTGGAAGTGTCTCATGCTGGA	AAACTGTGAGTGGATCCATTGGAA
AGGTTTCCTCTGGTCCTGGTAT	ACCTATGTTAAACATTTGCAAAAAGTC
CAGCTTGGACACGGCTTTAC	TTTAGCAAAAAGCACAACT
GCTGCAGTGGGACCACTATTAT	TAGTCCCTGGCTGGACCAA
GCATGATCTTCCTGCTTTGAACAAATAA	TGAGATATATAGATTAATTCTGCCTCCCATAAA
CTGAGGTTCAGAGCCATGGAC	ACAGAGACAAGGGTCACCTCA
