TGTCCCGTTCTTAAAGGAAGATGGC	TTCTCCCCGGCGGCGGCGGCAGCTCCA
TGGATAGTTCCATCTCACTACCAGACA	AGAAATATAAACGTCCTAATTTCAGTGTG
TATCAAGTGGGTGTGCTAGCATCTCTG	TATAGGCAAAGTGGTCCAACAGCAG
GTGTCACCTGACTGCATATGAGAAATG	GTAAAACCACAAAAGAATGGATGAGGG
GACTCAGAGTTGATGGTGTGTAGTCAT	TTTTTCTTAGGCTTAGCTTCGCG
TGCGAATGGAAAACGCTCTGACAGA	GGTTTACATATATATTAAGGCTTGTGTGT
TTCCTGAATGTCCACACACAAGATGAC	CATGGTCCAGGCGCCCCTTTGT
TTCTAACCCTGTGATTACTCACAGAAA	GTGATGTGGTCGAGAAGAGTTTGGA
GGCAACGATGCTTTAGATTGATCACT	CTAGAAGAGAGTGAGATGGTTAGCACC
CGTTTGTCTGATTCTTCCACCCAAAC	TAGCACTAAACATCATAGTGTGGCGG
TACCTCTGAAAACATCACACAGAAAGT	CACCCCTCCTTAGGCAACCTGGT
AGGAACACATGCAACTCTCCTTCAC	TTGGCGCCTAGCTTCCCTCTCCT
ACTTGCGGGACTGCCGCACCACATT	CAACCACTTCCCATCCCATGTGC
GGGTGGTCTTGAGTGAATATTCAAACC	TGAGGACACTCAGTGGGGGCTGATTT
AAATGCCCCGCCTAGCCCTTCAGT	GAGAGATAAGTGTAGGGATGTGTGTGG
ATTCCATCCCCCAGAGTCTCTCC	GGTACCACCTCAGGGGTCTGGC
TCTGAGCAGTGGTCATTTTATGAATCA	GAGGCGCTGCCTTTTGTTTCTAGAATA
GTCATGCTTAGCTCAGTTGTTTTGTGG	TAAGAGCTCATGTTCCTGGCTGCTGCTT
CTGTTCCTGTTTATGCCTTCATTTTTC	GTAAGTTTACTCTTCCTACACTTCACA
GGTTTTGAGCAGAGAGATGGAATACTC	AACTGAACTCTGCACAATGTAACAGAA
ATCAAGTATCTCATCCTGTGGAGAATA	AAGGTTCAAAATTGCATAGAGAATATGTT
ACCCTGATCAACTATGGTTGTGTGTAG	AGATTATCAATTACATTCTTCATTGGGTG
AAGTATCTATCTTTGCTTTCACTTTTGTT	CATATCTAAACATAGTACTTGAAATGCCT
ACTAGCTGCTGGACCAGGGAGGTGTG	AGAGAGGCTCTGAGAAACCTCGGGAA
ACCTGGCTGAGGAGCTGGGCCA	GGTCTTGCCTCAGCTCACGCGC
CGCGCAGGTACCGTGCGACATC	CCCATCATCATGACCTGCCAGAGAGAA
CTCCGCAGAAGTTCGGAGGATATAAT	AGCGCCCGAGTGGCGGAGCTGCT
AAAAAGGGGAGGCTTCCTGGGGAGTTTTC	ACGAACGTTTGGGATAAAAAGGGAG
CAGGAGGAGGTCTGTGATTACAAACC	CGCCCGCACCTCCTCTACCCGA
ACAGGGTCGGAGGGGGCTCTTC	TGCTGGAGGCGGGGGCGCTGCCCAACG
CAAGTGGAATGGAACTCAAAGACAATAT	CAGAATGGTTACTTCAGAAAAGTTTATGAA
TGTAGAATCTGCATTCCCAGAGACAAG	GTAGGAAAGGGGGAAGAGGATGGGAAA
GTGTTCAATATGATGGCAGGAGGGT	CAAATTGCTGATCCAGTACAGTCCAAAA
TTTACCATAAAATCATATGCTCCACTAAC	GAGAAAACATGGTAGATTTAGTCAAGGT
TTCCTTTCTACCCAAAAGTAATCATCT	GTAAGGGAAAATCTTGTCATGGTTGGG
GAGCAGCAGACTTTGTGGTCACTAAAA	CTAAAATAGTCCATTGGAAAGGGAGGC
GTATCCAAGAGGCCTAGCAAGAGAATG	CGAAGGAAACATCATGAAGAATAAAGAG
CTATTCTGTCTACCTCTGTATGTTTGC	TGTTACCTTTATGTTACATTAGTGTTTTCA
GTCAGTTTCAAGTCTCTCAGGTCCAAT	CTGATCGAGTACAGCAGTTGATGTAAAAT
CACTTCACCCAACCAAATGGCATCTTT	AAAAACACAGAGTCATCTGAGAATAGC
CTGACAGCTGTCAGCTTTAATAAGCCA	ACCTTTTAATTTTAAAAGGCCATTAAAGAG
GGATCCAAGAATTTTTCCATGCAGAAGTAA	AGATGAACAGGATACATTACCTACAAG
TGTTTGCCAAAATTTTCAACCAGTTTTCC	GATGTGGTTAGTAACCAACCCATCTTC
TGCTTCAATTTATCTGTCTCTTATATTTGT	AAGAAACAAACAATCTGAAATCACTGA
CAAACCTCCTAACTTCACTGTATTCTT	CATGGTTCTTTGCACCTGTAATCCCA
GGATGTGTGAAAAGGCTAAGTGCACAA	AGAGTCAAACACATTATAAATACGGATTT
TCTTCTCCACTTAATAAGCAGTTGATATAA	AAAGTTGGGTTTTTATCCCAGGGAAAA
AACGCTTCTTATGTAAAGCAGTTGAAA	CCTAGCACTTGGTCCAGTGCTCTA
GTATTTCCATTTCTTAGAGGGAATGGT	GACACAAAATTAAGAAACAAGGTATTTCA
CATACACGCTCTACCCACTGCAGTAT	AAAAATGTGCCTAAACAAAGCTCTCAGC
GAGAGTAACACAGCAAGAAAGTAACGT	AAACATTACATAAGGAACTACCCAACA
GCCAATATTTAACCAATTTTGACCTACA	AAAAATGAAGAGATTTTAGTGACAAACTG
TCACTAAAACTCTAAGGGCTAAGCCAG	AACATGATTGATAATAGGTCAGATACACT
TCTCTTCATCAATGCAAATCCTTACAT	CTTAAAAACAGAACCCTAAGATATACATGT
AACCTCTTCTTTATTTTCAGAGTGTCT	TGCAGCTTTTCTGTTACCAATAGTGAC
AGAGCCATGATAGGCTCCTGAAAACT	TACAAAGGAACTTTTGTAGTGACAAGA
CTCCCAGCTTCTCAAGGACAGTGATTT	TGTCATCTTACCTCTTGACTTTCCTTT
TCCAACTTCTTGATCATTTGCTTGAGA	GAGGACTTAACTACTTGTCAGGGACTAT
AAAAGGAGCAGAGTCTTGCCCTGAGTA	TTTCCTATATATCACAATTCTATCAGTCCA
TGATCTTGATGAAAAGATGAAGCATATTC	AGGCAAAATCTTAAAATATAATGCATTACC
ACACTTTGCAACACCTTCACCTAAAAT	CAAACAAAAATATCTCCCCTCAGTCCC
CTGTAAAGTGAGCAGCACAAGACTG	GAAAATTACAAATTCCCAAAAACCACATTT
TTAAATTATCTAGAAGTTGCCAAGGTAGC	TCCTGTTCCCCATTTAAAAGATATTTTAG
TGATGCTTAGTCCAGTAAGTAAATTCA	GTTTGTCACAAGAACACCTCTTTTAATGA
AATGGTCCCACTGCATATTCCTCCA	ACAGCAAAGATACAAATTAACTTAGACAAA
ACTAGAAGAACTTCATTACCAAGCAGC	ACATACCATATATATAGTGTGTATGTGTGT
GAGTCTGAACTAAGTCTGTGACAATGA	GAGAAAATGTAACTTGCTTTTAACACG
AAGTGTTGTCTTCATGCTAGTTTAAAC	ATTTTTACTGTATGTTTTCTGTTGCCTG
GTGTGAAGTATCATTCTCCATGAATGT	AGAAATTCTATTTCAGTAGAGTCATAGGT
CATGACCCACAGCAAACAGAACTGTTT	AACAATTCAAATGCCTATCAAGTACAC
GTCTTTATCCAAATGTCATGATTTTCACT	ATACAGTTAAAACTAAATCTGGAGGCA
GGATGATATAAATCTGTGGATTCCTCT	CCCACTCAAACTGTTGTAAATTTATTAAAG
GAAGACAGCTGGTGAAAAATCCCTGA	CATGCCCCGTTGACATATTAAATTTCTA
CATGGAGAAATCTGCTTTCTACACATG	TGTTTCTTCATCTATGGAATGGAGATAA
GTTAGAAGACTTTTCCAGTCCTCTTGAA	CAGCATTAAAGTATCATACTTTATCCAGAT
GATGAGGTGAAGTCCATTGCTAATCAG	TCATTCCCTGAATGATATGAGATATAACC
TGAAATAGACATTGAAGGTGTCAACCA	CTGCAAGGGCACAAAATTAAAATATATTT
GGCTTTTGGAAAGAATTTCTAAAATGCTTT	CCAAATTCAAAAACCATTTTTCTACTGAAA
ATCAGCAATTGTCATAAAACCAAGTTA	TGTTACATATGAGAACAGAATCTTGTGAC
ATAACGTCTCGAAGAACAAAGGCCCAAGC	AGATACTCGGCTACAATAAATACACTTTA
CTGAAAGATATAAAAAGTGGCTTAGGAGG	TCCTGGGTTCAGATTATCCTTCCTCCT
CCAACAATAACATGAAGATGGTTTTCTAGA	GCATCTCTAATTCTTATATGCCTTGACAT
ACAGCCGTGACTTACTGTAAGGATG	GAATTAACCTTTGTAATCAATTACAGAGC
TATCATTTATTACAGTAAGTTTTGTTGGCT	AAAAATCAAATACAGTAGAGGACCCTT
GCAGCTTTATACTGTAAACTACTGGATTA	GCAAGCAAACAAACAAACAAAAAGTGA
AAAGCCTGTTTTTCGCAGATAGGGC	CACATTTCAGAAACCTCCTACTCACTAA
ACGTTGATAGCTGTGGTTTTATCCTGT	GGGAATATTGGAAAGCAGTTATACAAAAAC
GAAGATTTAGCCATTCCAAAACCAGATA	CATTCAACTTTTCTTGATTTCCTCATCTAT
AGAAGACTTTATGGCATCTCATTTAGA	ACATACCATACCCATACACATGTGTGTG
CTCCTACCTTGGCTTTCTGGAATAATTC	AGTTCAGTTAACTGAGTTAAAGGTGGC
GTAATAGCTGAAGAGGAAGCATATAAGTC	ATACTTTAAGTTCTGGGGTACATGATG
CTACAATGAGTTGTGACAATCCCACTG	ATTGTGAATAGAAGGAAAAATGCAAATTC
GCACCTGGCCTTAATTTCCACATTTGT	GCAATTAAGACAAACAAAGAACCAAGC
TGAGGCCTCTTATACTGCCAAATCAAT	CAAGGAAGAGAAACAAAGATGTTCAAGA
TCCGAATATCAGCTGCCCTAAAGGAC	ACTCAAATTTCCTCCTCTTCACAAAAA
GTGTAACTACTGCTCAGACCAATACTG	TTTCTTGAGAAATGAACCTGAGACTAG
CCTGAAGAATACTTTCCTCTACTTCCTATA	AAGACACCTGGTCCAACCTTCCATT
ATGATCTGCTAGTGAATGAGATAAGTC	AAAAGCCTATAAAATGACTCTGTACATGC
CTTTTATTACTTCCCAGCCTAGTTCTATTT	TATCACCACAACCTCTACCTCCCA
GATTACAGTGTCCCTTGCAAAAGGAAG	CAAAGGGATATGTGATTGCCATGACAA
GGGTAGAAGCTGAGATAGTATCATCAGTAA	GAATCACCATCATTTCCATAGTACTCTAA
AAGTTTACCTAACTGTGAGCTGTCTCC	TTCGTGGTATAAGTTCTGAGCAAATAC
CTATGAAAATGATCAGGGATATGTGAGT	GGTAATACACCAAATTTTATTCCAGAGTT
AAAGAAAAGCTTCTATTTACTTCACACAT	GGTGACTAAATGAACATAAAAACTGTTAAA
AACGGTAAAAATGGGAATAGAGCAAAA	AATGCAGAATTTCCCAGATCTAACCTT
AACCTCTTCCCTGGCTAACAGTTGCAA	ACAAAGAAAAACAAAAAGCTTCACTTAGA
CTGGTGCTTTTCTATACCACATTCTCTC	CCTAGTATCTACATCATTCAAAGACTACTT
TTTTGACAAGATGGACTTTTTAACCATTG	GGGCAGGAAAAACAGCAAGGATG
CGCGACAGTAATCTGTTAAGCCATTTAT	GCAATTTCAGAAACTCGTTGAATACTTA
CACCAGTATTTTCTCACAGAAAGAATGTCT	GGCAACTATTTAAATAATTCCATTTGGGA
GAGCTGATTGTAGCAACATACTACTCA	AAATTATATGGTTATCGAACTGACCCT
GTCTGAGAACAGCATCCTTTGGTAAC	CAGAAAAAGGATTTTAAAACTGCACTAATT
AGAGTTTTAGTGGCTAGAATAATTCATGC	GTGGATTCCTAAAGAGACAACCAAGTCC
GGAAGAATTTCATCTCCTAATTCACACACT	ACCCTAATTTTCAAACAGTAGTCTTAATTT
AGACTTTGGCTGTCAACTTTCGAATTC	CTTCTTCATTCAAACATAGAAGTCTAAGT
GAGATCTTCAGCAGTTCTTTGGTACTG	TAGGGGAGAGTGGGCAGGCTGCAGGT
GAAGTACATGGACAGGCAGACAGATAC	AAGCCAAGGGGTGCCATGCTGGCAT
ATCCCTGGCCGGTGGGCGGGGGAGGA	TAAGTGTGGCCCCATCCCGGGAACAGG
CCGCACCTGACGCCCTGCTGGG	CTCTCCCCACTTTATGGTAAAAGAGACG
GGGAGCAGCGAGGCCTTCACCT	CTGTTGCGCAGCTGCTCCGGCGGCATCA
TGGAGGCACCGGACGGCGGGTGCGAGGC	TCCTTCCACTTCCTGCGGGAGCT
CCCGCATTCCAACGTCTCCGAC	CACATGTTTTTATACAAAATAAGAACGAGG
GGGCGATCTGGGACTGCATGCT	ACTGGGCTGCGGTCACGGGTGGGA
AGCCGCCACCACCACCACCACAGC	GCAGCACAGCTACTCCTCGCCT
CTGGCTGCTGAGCTCACGCCAA	TGGCAGCAAGGCTACTGTGCAG
AGCAGCGGAGGGGCCCTGAATTT	GCCCTGTCCCAGATGATGAGCT
ATTCAAACTGGTGGACCCGCCCACAGT	AGGCAGGTGGTTGAGGGGCACGGA
TGTGGAAGCAAGGAGGCCAAGGAC	GATGCCCGACACCCACCTGGGC
GGACTTCTTCCTCCGTGCCTTGA	GTTGTACTCGTCCAGCAGCCTCACGAT
ATGGAACCTTGGGGAGGGTCCCCACGCC	TGGTGCGCAGCCCGCAGCTGCACGGAG
CAGAAAAGAGGCAAAGATAATAAAGCTAT	TCCAGGACAAAATAAATGAATATTTTTGTC
CCTACTATGTACATGATATTTGATGCAAT	TTGCCCAACACAATGTATTCAAATTTTTCC
GACCAACCACTAACTAAGAGACTTTCC	TGTTGGAGAGAGCATGAGGCAGAAAG
CTTACACGAAGAAGACCAGCTTATCAA	GGAAAGAAAAAGGAAAGGGAAATCGAG
ATTTGTCGTGATAGGTGACCTGGAGCGGT	ATGTGTAAAGGACCTTTCTCCCCAGA
CATAACCCTCCCACCATTGAACTGTT	CCCATGGAGAATAATCACTGCCCA
ATGAGAGAGGTTGATGGGCTTCCCTTCC	ACACTGACAGAGGGTAGGACTCCTGG
AGGCTCTCCGAGGACGGGCTGCATA	CCCAATTAGGCGCCCTCCAAGGCTCT
GCAGAAGACAGACGATTATCCTCCAATC	CTACAGAGGAAAAGGGCAAGAAAACAC
TCCGATAGGCAGGTAGAGATCTTAACA	GTTTGTTCAAAGGAGGAAGGGAGAAAA
ATTTCTGGGTCGCTTCCTTTTCCACTC	GTGGAGGAGGTAAGAGATTCCATTTTC
TGGCAAGCGAGACACACTGGTATTA	ATCCTCCTGCTCAGCCTCCTTAGTAG
CCATAAGAATAGCTATCTGTTGTACAATC	TAAACAAAGAAAGGACAGTCATGAGTTGG
CTCTGTTATATAAAAAGGTAACAGTTGGC	AGAGTCCTCTGGTGGGGAGGGGTTTTG
CCAGGTGGACAAAGTCAACTTCCAGTA	TGTTAGGGATCAGGGTCGCTGCTCA
GAGTAGCAAGGTTACGCTAAAGGGTAC	TCTCACAGCGAGAGAGATCAGGAAGT
AAGTCCTGTGAAAACCACCTCAGAGC	GTTAAAAATAAGGGCAGGAAGAGGGGA
CGGGGGCGGTACCTGTAGTGTG	ACTGCGGGCACCTGCGCAGCCGTCG
TGCTGCTGAGGTGGCAGTTTCCT	TCGAACAGCCCCGCCTCCTGCTGCTCA
ACAGAAAAATGGTGATGGAGACAATTG	GTAATTTTTAAAATGCTCAGGGGGTTA
GCTGCTCCCAAATTACCCATAATTTTC	AAGCAACATCATGAAAACCAAATACTC
AATCTAAGGGTGAGGCAGATGCAGACA	GCGTAAACTTTTCTTCACATTTATTTTTC
CCTTCTTTGGATATACTCCAGTGCTCA	TAAGTGTGCCCGCTGTCCAGTCTT
CTTACCTAAACTCTTCATAATGCTTGCTC	AGAATTGAGGCTATTTTTCCACTGATTA
TCCCTCTCAGGCATAAGGTAATGTACT	GACATTGTGACAAGTCATAATAGGATATG
GGGGCACAGCAGGCCAGTGTGCA	CCTGTGGCAAGCAGGGGAGGCCTTTTT
CAGTAAACATATTTGCATGGGGTGTGG	TTCTTGTTCCCCACTGACAGCCTCCCA
CAGCTGTATAGGTACTTGAAGTGCAGT	TGAGTGACCTCAGCCCCTTCCT
TTCCTTCCCACACCAGGATGAGAATCA	TCATGTTTAGATCACAATTAGGGCAAC
GGCCACACCTGTGAGGCTGCAGTGATT	GAAAGGAAGAGAGTTCAGCGTGCACTT
TGTCATATTGTTCACTTCATCTAAGCT	GAAAAATCAAAAGACCAAATTCATTGCTA
GTTTCAAAAATATTTTTGGACATAGGTCA	CTAAGTCCATTTTCTCTATGTAAAAGAGAC
GCATTCACACACACTTTTATTTTTCAG	GACATATGCAAGACTGGGTAATTTATAAAG
CACTGATCTGGATCAACTAGGCCAC	CTTTATACAAAGTCTCTGACGTGGATGAG
CTGACTTTTCCTTTTCATTTTTATTTGAGC	AACGTGAAGCTGCTCATCCTCAGGTT
TGCTGCTGGGGTCTCTGCTGCT	CTAGTGATATACGACACCCATTAAGCA
AGAAGCAGCCACCACAGCCCCA	CCTCATCTCAAGCTGCAGGTTCATAT
AGGGTCTTGGCTTGGATACCTATACA	GAATAGAAGTTCATAGGGCTGGTGCT
TATTCTCCCCAGTCTCAGCCGATGGAT	CATGTAGGGAAATTGCCTCCTTATCCC
TTTTGGAGATGCAGGGCATGAAGAGAG	GTACATTTGGTCTAATGGTACAACTGCT
TGCAGCTCCGGGCATGTTCAACA	TGCAGAGGACAACGATGAGGTCT
CCATGTTTTGGCTCATTCATGCTCTTAT	AGAAGCCACACCCTGGACTAGT
ACCAGGATCTCCCTCGTCTTTTACCA	CTGCGTTTCATCAAGTCTCTTGCCGAA
AATACTGTGACCTTTCCCCACTGCCC	TAAGTGGGCTCTGAAGTTTCATGTGGC
GCCCTAAAAGTGTATGTATAACATCCC	CGTTATCTGTCAAAACTATGCTTGAAAC
ACCGACCCGGGGCTGCGGGGGCCCCTTT	CGCACCAGCTCGCCCGGGTGGT
TAGGAGCTGTTTGCAGGGTCCTA	ACCGACAGCCCCAACTTCCTCTG
TTTTAATAGGGCTTGGGGAGTCCCAGA	GAGTACATGCTGGTCTTGTAATATCTACT
AGGAATGGACTTAGTCTGTTGCCCTC	AAATATCGGAATACCTAGACATAGCAAA
TGTGGATGGCCCCGAAGCAAGCCTGAT	AAAAGTTATTATGGAATACCCTGTATGAAG
GTTTCAATTTCTTGATCTGAAGGAGCC	TTCTGGATGAGCTCTCTCAGGCAGTG
AGTGTTTGCAAAATGGAGGAATAAAACG	CTGTAGCCCAAGAAAATGCAGTTAAAG
ACCATTAGGCATTAGCACTGCCTTG	CAAATCGGAGACATTTGGTTGACTGCT
GAGCAGGAGGGGAAAAGTGCTAATTA	AATGCCATTAACAGTCAGGCTACTAATG
GGCATTATCAGCATCATCAGCATCACA	GGAAACACAATCTGGATAATATTGAGACAG
CACAGACCTCTAACTCTGAGCTGCCT	CCACAAAGCTAGCGTCTGGTGAAGAAT
GTGTGGTAGTGGCAGAAAAGGAATC	GGCATATCTCAAAAACTGATTTTTGTTGTT
TATTTAAAACAAAATGAAATGAATGGTGCT	CTACCCCAACCAAAGTAACACAACAC
CAGTCTGTATGTCATTCCTGTTCACACA	CAGAGTGCTTTTTCCTTCTGAAGGAAG
TGCAGCCCTTCTCCGATGCTTTCTGAAA	AGAGCAAGAGATTCTGAAGGGTCGA
TTGGAGGTCATTTGATTGGAGAGATTG	GTTTCTCATCAACTGCTGGCAGTT
ATCACTGCCATCAATTCTTCAGTATCAAC	TCCAGTTCCAAAAACCCTCACACCA
GTGAGTTTGAAAATGGCTCAGTCTCTGA	ATGTTGGTCCACTGTACCTTGGGACTG
GTGTTGAAACAGCACTTGAATCAACAGG	AAGCAACAATGATCAGCAAAGAGAAGG
CCTGTATTTTGCATGCACTTGATTTCATG	GGGGTGAGGAAAAGTCTGGAGTATTT
ATAAATCGTAGAAATTCCCCTTATAGTCAG	TCTTCACAGGTGCTTTCAAGAACAGG
TTCTGGGGAGGGGTCTGAGTGTGACTTC	GATCTTGCTTTGGGATCACATTATTTG
TTTTTCCTGTGCCTGACCAGGGA	CACACAGCACCACCAGAAAACAAAAC
GTGACTGGCCCTGACATTTCAACTTTT	ATACAGGCATGTGGCTTGCATCCAG
CTCTTACTCTCAAATCACAGAAGCAAG	AAAATTTATTGGATACACCTGTCAAGACTC
CACAAGACACAAGCATCGGTAACTT	TATAGGAGTATCTAGTAATTTGGAAGGTG
GTGTGTGAAGGCTGGAAAAATTCTGAC	CTAAATATAAAGGCTACATCCACAAAGC
TAACTGGCATGAGTCTTTGATCTGGG	AAGAAACCCACAGAAACACACACAC
ATTTTCATGGTGTTTTATCCCTCTTGA	GAGAAAGAAAATTTAAAATGAAAACCCACA
GATCCCGGCGGGCTTGTCGCGAACA	GGGGTTGAGCAGCGCGGAGCCGGTGGA
ATGGGCTCGGCCACGCGCTACCACAC	CCTCCCGAACCAGAGCGACGTG
CGAGCCGGGGTAGGGCGGCGGCAGGTA	AGCGGAAGTGAGTAGGAGGTTG
CCCACCCCACTTTACATATAATTGACC	AGCCACTTGAAAACACATTCTTTGCA
GTGTCAAAGCTATAAAAATCTCCAGTG	TAAATAAAGTACACACCTTCATAGATGTG
CATCTTCACTTTGCTTGACGTGTGTG	TCGGTGGGTCTGGGGTGGGTGG
AGATGCAGGGTAAGTACCAGATGGAGC	TCAGATCTGCATTGTAACCAGATCCCC
AGGTGCAGGAGAGGCGGGCAGT	ATCTAGTTTCTGCCGATGTCCTATTGTG
GGTGAAAGGGGGCCCATTCTGC	ATCAGACCAAGCCCGGGAGCTTGTCCT
CTGGTACACCCTCCAGGCTGGT	CATATGTTAGAACCATTCAGGGCAGCA
AGGAATCTGAGACATGGTCCCTGAGTA	GAGGTTGGTGGCCTGAACATATCTGTT
TCTAACAATGCTCTTGGACTTCTTGAC	AAACAAAACAAACAAACAAAAAGCCAC
GCAATACTTTTTCCTAAAACACAACAGT	GTGATATAAAGTTATCTTTTGCACTTAGGA
CAACATGATTGTCATCTTCACTTAGCCA	GGTATTTAAAAGAAACACTGGATTCCAGAG
CAAACCCTTTTGTGAAGATCTTGACCA	TCTGAGAATTTATTGGAAAACAGATTTTGG
ACATTGGAATAGTTTCAAACATCATCTTG	GTCGTAGCCATTTAAGAACATATATACATT
ATTATAGACCAGTGGCACTGTTGTTTC	TTGTTCAACTCATTGGGCTAAAGAAGC
TCTGTCCTTATTTTGGATATTTCTCCC	TGCATGGTTAAATACATACCAGTATTATTT
GCAAATGCTATCGATTTCTTGATCACATAG	ACATTTGCAAAAAGTCAACAAAATAAACT
GAAACCTCAGAAAAAGTAGAAAATGGAAG	ATTCTAGGAGTACAGCTGATGAAGAAC
TGCATAACAAATATAAAAACTACAGACCA	AATTTCCGAAGAAAGATAATCTTTCCTTAA
CTTCAGGAGATTAAACGAGGAAAAAGA	TGAGAAGATTTATATACATTTCAAGGCATT
ACACCATTTAAGAACAGAGACTGAGTA	GTATAAGGAAAGAGAAATAATCGTAAGCC
AGATCACAGTGTCAGGCTGAGCAGCC	GACTTAGAAATTCATGGCTAAGGGACAC
GGTTGAATACACAGAAAGGAAACACAA	CCTGTGGCTGAAGAAAAAGGAGGA
ACATCACAAAGTATCTTTTTCTGTGGC	AGTTAAGGAAAGAAATATCTGAAATATGCA
GGGAAAAATTTTTACAAAAGCCCAAAGA	TTATTAGTATGTGACTTTCTAAGGCTGTA
TCACTATGCACATTAGTTTATCCTAACA	AGTAAGCAAACTAAATTAAACTCACTTTTC
AGGTACTGGTGGAGTATTTGATAGTGT	CTTGTTTTAATATGCATATTACTGGTGCA
GGTGCACTGTAATAATCCAGACTGTGT	TGGGTTTAAATTGAATATAATAAGCTGACA
GCATTTTGGACAACACATTCTTGGCAA	GAAATGTGGTTAAGGAACCACAACACTT
GGAAGGTCACACTAGGGTTTTCATTTC	TGAGGCCCAGTGGTAGCCCGCTGACC
AGGAGTACAGCGCCATGCGGGAC	TGGATGCCGCTGCGCCTGCAGCCCCCG
AAGCCCTCCCCGGTGCGCATGTACT	GACTCCCCTCCTCTAGAGGAAGCA
ACGGTCTTCAGAGAAGCCATTATCTG	CACCCATTAAGCAAGGTATGAAATTGAG
CACTCACAAGCCGGGGGATATTTTT	CTCTATGCCTAAATCATAGCTTGAAAGAG
GGGGTTCAAATTCTGGTTGAAAGATGG	TAGGCCAGGGTGGAGAGGGGATCCAC
GTTTACACTGACACCTAGCTGTGATCC	AAAAAGTACAAAGAATTGTTGTTTGACTG
TGTGTGATATCCCTAGACAGGATTTAC	AGGTTGGAGGAGAAAAGAAAACCATTT
CAAAGGAAGCCACTGGAGTTCCTTAAA	GTGGGGAGAAAGGGAAAAATAGATCAC
GATGGCTACAGCTTAAGGTTGTCCTTT	AAGCATAGATAATTTTATTGTCAAGGTGA
TGAGGATACACTAGATTTTTAACCTGC	ATGTTGTAGTAATTATCATCATCTTTTGGT
CAGGTGATCATATTCAGGCTGGTTAGA	TTTTCCCCTCCTAAGTTCAATAAGTTT
GGTACCTCCTACTGAAGTTGAGTCTAG	GTGAGGCTGCTATTTCCTACTTATTTT
TGTCACAAGTACAAAAAGGTAAAAGCA	GAATGGAATGTGCCAAATGTTTCTGC
TTCAGATGGCCCTGCCAGCAGCTGC	TGAGCCTGGCGCCGCCGTCCAGGTGC
AGGCGCACTTCCTCCTGAATGTAC	GGAGAGTGCTATCATTTATTACAACTAGAA
GATTTAGCATTTGGTCCATCTATGTTGGG	TAAATATTGTGCATGGTGTTATCAAGAATC
CAGCTTTGTTATAGAGACATAATTGGGT	GAATTTGTTCCTTTGAGGCAATCTTGC
CCAGTTACTAGGCTATGCCTGTTTTGT	GCCTGATTATTAGGATTCTGTGTAGCC
TCTGGAGAACTGGGTAAAGACATGTAC	GAGCCATATGCTTCTTCTCTTGGAAAA
CCCAATTACTGCCTTAGAACAAACAGG	AGGCACTGATAACCTGTATTCAGGTG
CTGCAAGTTTTTGCATACGGTGATGAG	GAGCAACAAGTCACTTCTGGAAGATTG
CCACAGGTAGTAGGGAAGAATGTACTC	GTATTTGTTGCTTTGATGCAATTGCAT
GCTGTTTGAGTTGCTTCAAACTGATGG	AGCATCTTTCCATTCCTCTCATTATTAG
CGATGTGTGTTATATCCCCAGCATCTAG	GTGAGTCTGTCATGAAGCTCCTTAGAG
ATATTACACAGCCCTGGAAGTGTGGC	TGAGTGTCACATCCTACACACCCT
AGAGGGCTCAACACCGGGATCTATGT	TGAGCAGCGGGCTCTGCTGGGGACCC
TATGCAGGCAGCTGTGTAATTGGATG	TCCTCTGAAACAGCTGCCTTAGCTTC
GAATGGGAAAGAGAACTTGGCTGTAGT	TATGTTTCAGAGCTGGGAGGCAGTGA
AGAAGGTGGAGGAGGCCAGCCCTCCTG	TCGCTCTCTCCACCTGACCCCGG
CGGGGTCAGTGGGCTGCTGCACA	CAGTGACAGAAGGTCAAGGGCTG
GTAGAAAATGGGGTTTTCTCCCCTCTA	TGAAAGGATGGAGGCTGTGCAATGGG
ACGTGACCTGGAGTCCTAGACAAAGAA	TAGGTTCCTGGACGGAGCCCCGGGGAGA
ATTGTGTTTGAGGCGAGTGCCTCCTT	TGAGGCGCCTTCTGGCCTGGGCCCCA
GGTGGGCCATCATATTTAACACATGAAC	AAGTGTTCCACCCCCAGGGGCTCTGTG
AAAATGGCTGCTGCACCCCCAAGGAGG	GGATGCAGCCTGCGCATATGTTTTATT
CCGCTTCTGCAGGGGCTCCTCG	CTGGGCCATGGATGGGGACTTGGAGAT
GCATGAAGGTTTATATGAACACAGTTTCT	ACTCAGGCGCCTCAGAGCTATTA
AGACTGGGGTCACAGTGCCTCCCTTTT	TAGGAGCACACCCACCCAGGAGAGGT
TCACTACTCAGAGTCTGGCCTTGAGC	TAAATGAGGGCACCCAGCTTTCTGGG
TATCTGGTCCCCTCCAGGGCTGAGAC	TGCTGGGAGCTCGGAGGAGGAG
CTCGTGACCACTGTGTAATGATTTCTG	TAAGTTGTGGGGTTTGGCAGTAGCCT
GAAGACGGGCTGCGCCCCACAGCAT	TGAGCCTGCTGGCCAACAGGACCCAT
AACCCCGGCAGGAGGACTCCGTGGTG	TGGCATACAGAATCAAATAATTTCCTTAAA
CCTGGGTGGTTAAAGGTCAGCCCACTTA	GTGGAGGTGGCGGCGGGGCCACCGATGA
TATGCTCCCCATTTAGAGGATAAGGCG	AGTGGTGGCCGCCTCTCTATGGC
GGAGGCCCGAGCACCCCTGGAAAGTGTA	CCTCCCAACTCCCCGTTGCTCCCACT
TCCTCATCATCACTTTCCCAGGAAGTG	TAGCCCTCTGTAGTAGGCAGCTTTCC
TGGAGCAGCCTCAGTTGCATCCGGATGTTA	AAATGTGACCCCCAGTTCCACACCTGAAT
ATGCAAAGAACTGTTAGAAACGAGAGC	AGAGCTTGGCCAGTTCCTTTCTCTAA
TCATGCCCTCCTATGAGGGAAAGTGATA	CCTCCTGCATTGCCTGGGGATTTGACA
TCAGTGCTTCAGAGTCTCCGTTGAT	AACCTGGGGCTCAACAGATGGTATGT
GAGGCAGTGACAGCAATGGCAGTTACT	ATGAGAAACCCAATTGGAACCAATCTG
TTGGCTGGTACTCAGTACTGGCCAGC	ACTGCAGCTTCTCTAGTGTCAGCCTC
GCTGGGTGTCTCGAGTATGTGC	TCAGAATCCCCACAAGTACCACTTAC
AGCCTGGGTGGCCTCAATCCTG	ATGCTGTCATCGTGGGCTGGTGGAAGA
ATAGCTGTGAAACAGGCACTGGTCTT	CGTGCTATGTCACAGGACAGTAATTC
AGCCACATTCCCAGAGCCAAAAA	CTTCCTTCTGATCTTCACAACTAAAGGA
AGCAATGTTACAGGCCAAGGGAAGAA	CACATGCCTTTGTTGGCAGCGTCAAGAAT
AGGGGAGAGAAGAAGGCTCCAGAG	TTTGGAGCCCAGTCTTCCCTTGGA
AGAGCCAGGGAAGGGGCTCAGTGA	TGCGAGCCACAGTGCATCACTTTCCTT
CACTAAATATACAATGTTTCCCATGGCCAT	CAAAGTTTGCTTTGTGGCTCAGCTG
AAGCGGGTGGAACAGCTGAGCCGCG	AGGACTAGGAGATTCCGGTGCCT
GCTCTCTGGCAGCTGGCGGAAGAT	CACCGACTTCTTGGCCTTGCCC
ACTGCGGCCAGACCACCATGCA	ACAAGAACAGCAACGAGTACCGGGTGC
TGGGCGGCGGCGTGGGGTGACCGGGCTGCA	AGCGCCGGCGCCCCGACGCGCTCGTACA
CCTTCAACGACGAGTTCCTGGC	GGCCGCTGGTGATCAAGCAGGA
TGCCGGCTGTGCTGGAACAGGT	TCGGCCGACTCCATGGGGGAGTTAGA
ACAGAGGCCGCCTCGGACTCTAGG	TTCTACGAGGCGGAGCCGCGGCCCCCG
TTCCGGGCAGCCTGGTCTGGCCAGCA	ACATGGGGGCAAACTGAGGTAGCGAC
TACCTGGCATATTTGGTAGACGCATG	TACCCGGGTTGTGCTGGCATCTGGCT
GGGAGTTTGAAGAGAGTTATGACGTGT	TCAGCTCCAGCGTCTAGAACCTCTGC
CAGGCCCAGGAGCTTTCACCAA	CTCCAGGAGAAGCTGGAATTACACCTA
ATCCATTGGCAGGGCTCTTGCCTGTGG	CTGCGTTCCAAGAGAGAACAAAAGAGA
CTGGTAAAGGAATTGGAATAGAAGACA	AAGGCACAGCATTCCACTGGTCAAAA
ATGACCCAAGTGTCACTGCAATCTCCA	GGGAGAAATAAACCTCTTCTAGTAAGTG
TATACGCACTGATTCTCCTGGGACA	AATAAATCTGTGTGGTGCACAATCTAA
AGGAGGCTGAAATCAAAAGTGGCTTG	TTCCCCTCTACAAGGATGGGGAGGCTAA
TGAGGCAGGCTAGGAATTCTGTCTG	TCTGAGGCCACAGATTTTGCATCCTT
CAACTTGGCACGTGCCTCTGCATCT	TGTTTGATTCCTGGCTGCCCTG
AGTGGAAAGTTTCCAGTCTAACACTCA	GAAAATGGTTCTATGACTTTGCCTGATA
TAAAACAGTCAAGAAGAAAACGGCATT	TTGGTCTCCTCCACCGCTTCTTGT
CCTTACTGCCTCTTGCTTCTCTTTTCC	GGTGCAGTTATGCCTCAGATTCACT
CCTCCTCAGCATCTTATCCGAGTG	TGACCTCCCTATAACCCCATGAGATGT
CCAAATACTCCACACGCAAATTTCCT	ACTGCTTGTAGATGGCCATGGC
GAGGTGCTTACGCATGTTTGTTTCTTT	ACAGCACATGACGGAGGTTGTGA
CGGCCCAAGGAGGGAGATGATC	ACTTCTGCTTTGCAAGGGGCCTGTTTG
CACCACATTCTCAAAGAGCCAGAAGA	CTGTCCCAGGGCAGAAATATCCAA
ATTTCTCTTTCTTCCTGTCTGCCTC	TATTCCCGATGACCCTGTCTTCCCGTG
TCACTGCTTAGGACCCTCCAAAG	CAGCTGTTAAAATATTATCCCAAAGGGGA
GACAGCACCCGGATGGGCTTCCTCTT	GCTCGAGACCGCGCCCCAGGCCCAGCA
TCTGCTCACTGGGTCTCCTTCC	CCTTGGCTGAGCCTTGGTTGTG
CACACACTCCACGCAAAAGCAC	GAGGCCACAACAGCCTCACCTG
TGGCGGGGTCATGTCTTCAGGGC	AGTGGTCTCCTTAGCTGGGCCCCAG
AGGCCTGCATCCGAGGAGCAGG	ACGTCCTGCGTGTCACACCACCT
GAGCTGGCGTCAGAGGAGGCCG	ACTTCTTTGTAGGGATTCTTCTCTTCTGG
CCCAGTGGGAACAGCCGGGGTC	TACACGGACATGTGGGTGGAACCTGAG
GTGTGTCTCTTTGCAGTTATGATGGTTA	GGTCACTTTGCCATGAGCATTAGTG
TGGCAAAAATACCTATCCTGTGATCACC	TAGCAGTTTGGATTTACCGAATGATTTGC
CCAAATGTCATTTCTTACTGAATGAAGCT	GCAAAAGGTAGGTACCTTTGACGTGAG
CACTTGGGTGTTGTATTGTATGAGTATTTG	GTTAGCTTTTTAAAAGCACTTCAAGATTG
AAGAATGCTGCCCAATACTTCAGGGT	CAGCTGCCTGTTGCCTAACTTTA
GTTTGGGTGGTTAGAAAAGGTTGACTC	CTTGATTTCTCGAACTGCTGTTGTCAT
TGGGACAGATGGTGTAGAAGCAAACT	CACAGTTTATATGTGCTTGATTATGAAAG
AAGGGAGGAAGAATCTCTGTTTTAATG	AAACACTTTAAAATTCTGTTAGAACCATG
GGATGCAGAATATGCCAACTACTATACTA	GTTACACGAATACTGTTTGATTTGTTTTTA
GAATTCTCGAATAAGGATTAACATCACTTC	TTCCTCTGTGTTGGCGGATACCCTT
GAATCTGGATGATATTGTGTAACTTAGGT	GGTAAATCCACCAATTACCTTTTGATT
CTGCTTTAAAATTTTCAATGGAGATCTTAC	CTGTGCTAAACTTATTTGTCATTATGTGG
GCCCTAGTAAATTGCCTTAAAACTTTGC	AATGAAGTATTTACACAATTTCTTGCTGAC
ACATAAATGCCAGGCACACCGTAT	ACAGGAAAGTCTTTTCCCATTACATTA
GAAAAATGCAATTTACCTAGTAATGGGT	ACTCCCAACTCTAAATGTTATGTTATAGAA
GGGAGCCAGATAGTTTGTATGGCTGT	ACCTCGAAACAGCAATCCCCTCATCAA
ATCCCTCTGCTTCAGGAGTATCCCT	ATATGTTACTAGGGCTTTGCCCCAC
GTAGGGTGAAGCTCAGTTTCATCTTCC	TAGTTGATGGGGGAGGGGAACAAACAT
CCATGAATCCTTTGAAAGCTTTGTATT	GTGTTTTTGTCCTTAGTGATATTGACCAG
GGCTGAATGAAAGGGTAATTCATATACTG	AAGGTTTCAGTGAGGTGAACAGTTTAA
CCAGGATGTAAGACAGGATGTGCA	GCTTATATAAAAATGTCACAACAGTGGTT
AGATTGAGCCCTGTGGACACCTCAT	TCTTTTGCTTCTTCTGCAGGAATCAG
CATCATGAAGAGAGTATCATCAGCTCGT	AGTAACAGATGCATCTGAAAATACTTAAA
CCCCAAATTATGATGATGATGATGATG	ACAGATATTGTGTTAAGCACTTTACTTG
TTTTAGTATTCAGGAACATTCATGTGTTAT	CACTTTAAGTCTCAAGAAATGCTACAGAGA
GAGACCTTGAAACGATTCATGAGACTC	TGGTATCATCACACTCTGATAATGAAAGTC
CCTTGGATTTTGCTGGCTCAGAGA	AGCAGATGAAAAGAGCTATAAATTACATT
TTTCATCTGTTCCATGGGAGGATGTG	GTCTCCAGAAATGAGGAGAAATGGTCT
TTAAAGGGCTGTCAGAAGATACCAGG	CTCCACACAGAAGCAGCCCTAGTGACA
GGGCTTTAGATCACAGGGGAAACAA	CCTATCTCTCTGCAAATGTAAAAGAAAAA
TGGCTTCATTAGACCCACAGCTCT	GAATACTGACAAGTTCCTAACCCTTTCTA
AGTGGAGGGAGAGGAGCCAGAGGACA	ACAGAATCTCAGAGTCGACCTCTTTCC
TGCGGCCCCCTGTTAAATGCTACT	GAACAGGATGCGTTCGAAGATGTTT
TAAGGCATGGAAGGTCCGAGAGT	CTACCCAGGAGTTATCTGCACACAAT
GTCAACACCAACCTCCGTGCCCTGAT	GCCTGTTGCGTCTCAGCAGCAGT
GCCTGTCTTATACTAAATAACCCTTTGAGA	ATCCGTCCCCACCTAGAAGGATC
CTTGAGCATCTTTACAGCGACAGTC	TGTTGTCCAGAGACATTTTCCTACGAT
ATGGCTTAATTAAGTCAGATGCGGCC	AATCACATGAATATTGTGAATCTACTTGG
TCTGCATTCTTAAGAACAATGAGGAAA	CCAAGGTAACTCAGGACTTTGAGTTCA
TATTCTGTGATCCCCATGGACCGCAGCA	TGAAGGGCCCTGACTGCTCCTTTCCGC
AGGATGCGATTGAGCATGCTCTCCAA	TCCCTCGGGTCCCCATGCTAACGCTTTT
TCTTGGATGTGGCTCATGGAGCCT	CTACTTTGCCTTGGTACTGATCTTCTG
CAGGATCTCGAATCAGGCGCTTAAAT	CAGAACACACATCACTGTCTGTAAAAA
TCCTTTTTATTTTCAGAAAGAAGTTGAGA	CCTATATATCATTATGCCTTGCATATGAAT
TAAAGTAAATGATTTGTGGATAAACCTGA	TTTTTACCACAGCAATGTGTGTTCTTTG
CGTATCCACAGATAGCAAAAGAAAAAT	AAAAGTTCAACTTTATAAGCTTAACAGAAC
