TAATCAGTGGAAAAATAGCCTCAATTCT	GAGCAAGCATTATGAAGAGTTTAGGTAAG
CATATCCTATTATGACTTGTCACAATGTC	AGTACATTACCTTATGCCTGAGAGGGA
TGCTGCATATTTCAGATATTTCTTTCC	AGCCACAGAAAAAGATACTTTGTGATG
TGGCTTTTTGTTTGTTTGTTTTGTTTT	ACCGATTAAGTCAAGAAGTCCAAGAGC
CCTAAGTGCAAAAGATAACTTTATATCACT	CTGTTGTGTTTTAGGAAAAAGTATTGC
TCTCTGGAATCCAGTGTTTCTTTTAAA	ATGGCTAAGTGAAGATGACAATCATGT
CCAGGAAGAGGAAAGGAAAAACATCAAAAA	GGTCAAGATCTTCACAAAAGGGTTTGATA
ATGTATATATGTTCTTAAATGGCTACGACC	CTGTTGTTTCACAAGATGATGTTTGAAAC
GTTCAAATGCTTCAGAAATATAGTCTCCT	GCCACTGGTCTATAATCCAGATGATTCTT
CAAGATTGCAGATACAGAATCCATATTTCG	AAGTTCATGTACTTTGAGTTCCCTCAGC
CACCTGCAGATCTAATAGAAAACAAATTAT	TCTTCCCGTCGTGTGGGTCCTGAATTG
GTTTATTTTGTTGACTTTTTGCAAATGTT	AGTCTATGTGATCAAGAAATCGATAGC
CACATACATACAAGTCAACAACCCCC	CCATTTTCTACTTTTTCTGAGGTTTCCTC
GTGGGTTTTCATTTTAAATTTTCTTTCTCT	ATCAAGAGGGATAAAACACCATGAAAA
CTCTCTCCTCCTTTTTCTTCAGCCACA	TTGCTAGGTCATATATTTTGTGTTTCCT
GGGCCAGGAAGGGGCTGAGGTCACTCA	TCAAGTTACAATTGTTTGACTTTATGACGG
TCCCCTGCTTGCCACAGGTCTCCC	ACACTGGCCTGCTGTGCCCCAGCCTC
GGGAGGCTGTCAGTGGGGAACAAGAA	GGGACAACGGGAATTCAAATCAAGATG
ACTTGAAAGATTCATGGTCTCTAAATTTT	TACCCATGACAGGACTAGGATAGGAAA
TTTAAGGATAAGCTGTTAACGTGTTTTT	TTGGGTTACTGTGTTTTGGGGAATTTG
CAGAAAGTGAAACTAACTTTTATGTTCTG	CAGTCCTATGGACTTTTGTCTGAGACA
TTAAATCTAGGTGGTGTGTATGTAAGGTG	TCACACCTGTCGTGAAGGAAACCA
GGGCAAAAGAACTTGTCTCAAAAACAAAAA	GAAAATGGCAGATTTCTGGCAGCAA
CCTGTCCCCTAATACTTAATTTGATAAGT	ATTGTGCTGAACTAGAACACCAAACTG
GCTTAAATGAAGTTCCATGTTTATCTTTT	CACTACAAATCATTCTCCTTATCTTGTGTC
AAATGGTTCCCTGAAATACTTTGCTTA	CCAAACTGCTGCTTTACGTTTGGTG
TGCATTCTTTATAGTATGAGTTTTAGAGGC	AACTGTGTAAAGCAAGTACTTACATCA
CTTATCAACGAAGAGTCAGAACTTTAATG	GACACAGGCAATTGCAGCACTTT
TTTTCTTCCTATTGGTCTTTGTTTTTCTC	GTCTTTATCCTATTCCTGCTGCTTTGG
TGTCTGATACCATGTTTTTGTTTTGTT	AATTGGGTTTAGCTGAAACGCCAAGAC
TGCTAGTAACAATGAACTTTATGTTACTGC	GGTTCTATTTCAGCTTCTCCTTCCTCC
CCTGTACATGTTTCTGTGGAACCCT	TTTTTACTCAGTCTGCCTCAAAGCAC
TTTTTGTACTTTTGTCATGGAAGAAATGT	GAATGGATCAACATGACTGGCTTCCT
ATTTGCTGACAGGTGTATCTGCGTTTCCC	TATGGATCCTCCTCCACTCACATGGGA
CACCCATGGGTCCAGTCAGTGAACGTAA	GCTATTTAACAAATTGAAGAATACCATCAG
TGAGATGACTCTTCTTTCTGCAATTTT	TTGGATACAGAGCAGGACTCAATTCTA
GCTGTTTCTCTTTTCTCCACCATTCT	TTGAGATGTCAAACTTTTGTGTTTGAA
TTAAAGATTCCAATGAAGTCTACACGTTGC	TCATCAGTTCCTCCTCAGAATTCCC
CAATGTATTATTCATCCAAACTGACTCAG	GGCATGGAAGAACTTTTCAGTCATCTG
GACTTGTTTGTGCTCATCTCTGTTCTG	TTCTGGCACAAAATAGCTTTCATTTCA
CTTATACTCAATTCTCAACTCCTTGTTTT	TCCCCTTCCAACTAAATTTTCAGCTTT
TGTTGAAAATTCTAATGACTTTGCATTTT	GGTCATGAATAGTGCTTTTTACTTTGC
AGTGCTAAATGTGAACTGCTAATTTTT	CTTTTTGGTTGAGAAGGAGAGTTTGCC
AAGCCTCATAATTACTCTGTTATTTTTCTT	AGAGAGATGGCAAGTTTGGTTTTTCCC
GAGAGAAAGTCTGTTTTAAAGCGATTGCTA	ACAGATGCCACTAATCAATTTTATTTTATG
AAGCCATATTATGCAAAGCCATATGAA	ACTGGCCTCAAAGGTAGCAAAAGGCTT
CACAGACTGGAACTTACTTTAATAGAAACT	CCTGACCCAGGAGTTACAGTTATAGATATA
TACAATGGTGGGAACTCTTCCTTAAATGG	CTAAATGACATTTATTATGCTTCGGAAATT
ATAGAGTCGGGCTGTGACAGTTCCCAGC	TTCGCTCTGCTGAAGTTACTTGGACA
GTCCAGTCTATCATTCATATCCGGACC	TGAGACCATTTAATGAATTTTAAAACAGCC
TTTCTCCAGGCCTGATTCTAGGTAATAG	AATGATGATGCCAAACGACAAAGAGTT
AGTGCTTTGCCCAATGTGGCACCA	TGCTTGCAAAAACGAACTAGATTTGAC
CGAGATTCAGTTTAGGAGTTAATGTTTT	TGGGTATCAGTGTTGAATGTTACTTTC
TACTAGCCTCAAACATATCTTCTTTGCC	TAGTACTCTTCCATCTTTTCTTGTTGC
CTCATCAACCATCTCATGATTATCTTTAA	TGAAGTAAGTTAGCCCTTATGTCTTAC
ACCTCAGCAGATGCTTGTTCAAA	AAGGATCACCCAAAAAGTACAAATACC
AAGTCACACTTGTGATTTGTTAAATTTTT	ATTTTCCAACTAATGGAGGCAAGCAGC
TCATGGATTTCCTGGCTCGGGGACTG	ACAGCAATCAATTAATTTTAAAATTGCACT
GCCACCTATCCAACTGTCGGCCAGA	TTTTCCATGTCAGTGTAGCAAAGTTTTTG
AATGAACTTGCATATTCTTAACTTTTGTTT	CATGTTTATTTTCCAGCCATTTCTTAGA
ATTTAATTTTCCTCTAAAATGTTCCTCTGT	GCTGTTGTAGAATGCACTGACTACAG
TACCTTGCTTGTTATAAGAGTAAAATTTGA	TTTTTCCAGGAGGCAGCATGGTGTT
ATACTAAGCTGGCTCTGCAGTGCAGGAGG	AGCCAAAAATATTAATTTTGTTTGGACTT
ATCCCTCCTGACTCCCACATCTCCTTA	TATAGCAAATTTTGCTCCTTTTTCTTATGA
ATCTTATGAACATCACTTACTTGCTTTTT	GCCACCACTTTATAAGGTCTTGGTACT
TGGAAGGAAAAGAAGAAGTAACTGGCTG	CTTAACATGGGCTCTTCACTAGTGACC
TTCCTCCTTCTAATCTCTCTCGATTT	ACATTCATGATGTTCCTTTGGTGTGTG
TCAGTGCTTCAGTAAAGCTTATTTATTTA	CAGCTTCTTCTGTACTTTTTCTGTATC
TAGTTGATCATACTTTGTAACAGAATCAC	GCCAACAACACCCTCTTTATTGTCTC
GTCTTCACTGGAAAATTCTGAAATGAAAGG	GGGATACATAAACCTGATGTCTCTAGTAA
TGAGTCTTCTCTTTGTCTTTCTCTTTT	AACTTACACTTCCAAAGGTTTTATGGT
TCCTACCTCCCCTCACCTACTCTGT	TCTGTGGAGTGCAGGCTCCCAGTGTTC
GGTTCTCTCTTCTGGTGAGATCCTTTT	TTGTAACTGGTACACAACAAAATGTAAA
GGCAACTTTTACATTCTAGATTAAGCAG	CCTGCTGAATACAACTGAGAGTACTCA
TTACCTTCATTACTAATTCTCCCTTGTC	TCTATAAATATTAGAACCAGCCGGGCG
AGGAAAAAGGCAAAGACTTTGTACAGAC	GCTGCTTTTTAAGAACCAAGAAGCTG
CAAATATTCAAACTGTATCAGCATCCTCA	AGCTATTGAGCTGACACAGGAAGAACC
CATTTTCCTCTGAGACAACAGCGGCAA	CTGTACTTAATGCTGCTGAGCAATCAC
GGTTTTTGCTAAATCTGGAATGAAAATT	ATTTTAAATATGAAAATACACAGTGGCTGA
TCAAATGACTTAATGGATAGATTTGCTTAC	ACATAGGTCATACAGTTTTGAACAGTA
TCATCAAGGAACTATTCCAACAGAACA	TCACCACTGATTTCTATCTTCCAAAGG
AAAAAGAAAATGTGCCATACAGTTGCA	TCAATTTCTTGGTGGGCGGTGCCAGAT
TGTGTGTTCCATGCTGGCCTCTCAGGA	GATGTGGAAAGAGACAGGAGGAGTAGA
TGCTGTATAAATCTAAAGGTTCATATGCT	AACATATATCCCACAAATGGGGAGGAG
ATCCCCAGAATCACTGAACATGAAATGC	AGCCAATCAATGGAAAAACAAAATTATG
CCAACTGATCACAATTCACTCATATATATC	GCTCTGTTCAGACTCTAATAGGAGGTT
TCAGTAAGCAAATGTGACATAATTAGAAT	CCAGCAATCTGAATGAGAAAATTAACCAT
TGAAATTGCTATTAGCAACACAATATAACA	TGTATAAGAAAAACAAATCCCAATTCTCTC
TTATTGCAGACCAAGTCAACAATTTTT	TCTCATAGAAAGGTTGATAACATATGCA
CAACAACAAAAACCAAACAAGTTTAACA	GTTGCCTTATAATCACATACATTTCTCTG
TTCACATATCAATAAACAATCAACAAAGTG	CTGGCTATGAAAACAGAAGAAAACCTAAG
CAGCTCTTAGTATTTTGGGGTCTATTTT	CAGAACAATGTTCTACGCACATTTTGTTC
TGTCAGCTTATTATATTCAATTTAAACCCA	ACACAGTCTGGATTATTACAGTGCACC
TGCACCAGTAATATGCATATTAAAACAAG	ACACTATCAAATACTCCACCAGTACCT
AAGTGTTGTGGTTCCTTAACCACATTTC	TTGCCAAGAATGTGTTGTCCAAAATGC
AAGCTTTATAAAGTCCTGGCTGCTACA	ATGTTTGTTTTGTGGCAAGTCCTCTAC
CAACCAAATTACAGTCTGACTTGAACT	AAACACGTATTGAGATCTGCCATGTGC
CCAAGGGAGGCCAGCAGCTGCCCAACTTA	TCTTTTGTATTAAGATGAAATGCATCATCT
GCAGACTTTAAGGGATACAAGTTAAAAT	AAAATAGAGCCAGTCTTCACTTTTGCC
CATTTCCATTTTAAAGTGCTACTACTTAGA	TTAAAAGCACACCATCCATTTGTCCAT
TAATTACGAAACCCTGACCCAGCCT	TAGCAGACAACATACTCTTAGGAGGGC
TGAGGTGATTTTCGTGGAAGTGGGTT	AATTCAAAATTATGAGAGAAGCCAGGC
ATAAAAATCAAATTCTCGGCAATTTAACTT	CCTTGAAATGCTCCTCACTTGCTAAAG
ATGGTATCTTAGAGTCCTTTGTGGTCTC	TAATATTCATAGGGAAACGTATTGAGAAGA
CTGAAAATGAAAGTGCATGATATTATAGTG	CTAGAGCCAGTTTTAAGGGTCAAATGG
AGAATAGCAGCTACCATGGATGTGTC	AATTCTCTTAGCAGCCCCTCAGAAAAG
CCAGGCTGGAATACTAGTAGCAGGCT	ACTAAAAAGGCAGTTTGGTACTCCAGC
TACGAAGCTGCCGCTGTGGAAGTGGAT	GTTTCTGTTCATGTTTATTGTAAACCTTTT
CAGCACTTGCAGTGTGATGGAAGCAGATA	ATGCATGCTGACACACTGCACGCAACA
TCTCTAGAGAAAAACAGCTAAAGGTATAA	ATGCACACCTTAAAAAGAAAACATGCA
GGAGGGATGAAGTCCTTAAAACTAAATTG	ATGCACATGTTATGCGCCCATATTAC
GGGGCTGCGAGCGAGCGAGCGGGGCCTTA	GGGGGAGGAACCCTCTCCCCAGA
ACAAAATAGCCGTATAAAAATAAGTAGGAA	TCTTCTAGACTCAACTTCAGTAGGAGG
TAAGCGTTTCACCATCCTTCTTTTT	TTAGGAAATGGCTTCATGCTTTCAGAC
GGTCAGCGGGCTACCACTGGGCCTCA	GAAATGAAAACCCTAGTGTGACCTTCC
ATTCCAGTATTAACTTTCAGTAATTACCCT	ACTTGCTATTATTGATGGCAAATACACAG
TTACCCTCCACACCCCCAGGATTCT	CTAGGAGCATTATTTTCTCTGAAAGGAT
CACCATCTATAACCACTTGTTTTCTGT	AAACAAAAAGTATCCAATATCACCCTACA
AGCCTGTTCCCGGGATGGGGCCACACTTA	GGGACCCGAGGCTTCCTCCTCC
CCTCGTTCTTATTTTGTATAAAAACATGTG	GTCGGAGACGTTGGAATGCGGG
TCCCACCCGTGACCGCAGCCCAGT	AGCATGCAGTCCCAGATCGCCC
TGGGGGTGTTGTCCACAGGCGAGGAGTA	CAGGTGGCCGCTGGCTGCTGAGCTCA
CGGCTGGCCACCCAGCCTCACC	CAGGCAGACGTGCAGCCACTGG
CAGGTTCTGCTGCTGCATCTGTAAGTT	GGTGCCACACTCCCCCGCAGAGGGTTGTAT
TCTCTCCCACCTGCCTGTGGCCTCTGGC	TGCAGCATGGCATGGTAGGCCCG
CCACAGTGAAATTCAGGGCCCCT	GAGGGGCACGGACGGAGACTGCTGGAA
AAGGAGGCCAAGGACCTCAAGGCACGG	ACACCCACCTGGGCATCGGGCACCTG
GCATGCCGGAGCTGTCCAGCAG	GCGGGGCTCCGTGCAGCTGCGGGCT
CAGCTACGAGACCGCCAAGGTG	TCTGCTCGCCCAACGGCTACCTGGGC
CGTCTCTTTTACCATAAAGTGGGGAGAG	TCACCTGGCCCAGCAGGGCGTCAGGT
ACTTCCTGCGGGAGCTCAGCCGCGTGCT	AGGGTGGGCGGCGGCGGAGGGAGCT
TTGGGCCCGGAGGCCAGCATGCAGT	TGCAACAGCGCGGAGTGCGAGTG
TTCCCGAGGTTTCTCAGAGCCTCTCT	CACACCTCCCTGGTCCAGCAGCTAGT
GCGCGTGAGCTGAGGCAAGACC	GACATCGCGATGGCCCAGCTCCTCA
CCGAGTGGCGGAGCTGCTGCTG	ACCAGAGGCAGTAACCATGCCC
CGGCGCAGTTGGGCTCCGCGCCGTGGA	TTGCTTCCAGTTTCCAATTTCCTTCTTG
CTCCCTTTTTATCCCAAACGTTCGT	GAAAACTCCCCAGGAAGCCTCCCCTTTTT
ACCTGGATCGGCCTCCGACCGTAACTATT	CCGAGCGCACGCGGTCCGCCCCACCCTCT
TATGTGTGTGTGTTTCTGTGGGTTTC	GGTTACCCAGATCAAAGACTCATGCCA
AATGTTGCCCTAATTGTGATCTAAACATG	AGGCTGCAGTGATTGTGATTCTCATC
AAAGATTGGGCTTTCCTATCAGTGGCCGC	ACAGGTGTGGCCAGCTCGCTCCCGCAC
CCATAGCAATGAATTTGGTCTTTTGAT	TAGCTTAGATGAAGTGAACAATATGACA
TCTCTTTTACATAGAGAAAATGGACTTAGA	GACCTATGTCCAAAAATATTTTTGAAACA
ACTAACTACTTTCGCATTCACACACAC	CTGTTGAGTCTGTTCTCACACTGCTA
TCACTGATCTGGATCAACTAGGCCA	CCTTTATACAAAGTCTCTGACGTGGATG
CTGCAGCTTTCTTGGCTTCTAGTTTC	TTCCTCCAAATTCTCGATTGTCTTCTC
CAGAGCCAGTCAAGACTTGCCGACAAA	TTAAAAATGAAAATTATTTTGGTTTTGCCC
CATAGGGCTGGTGCTTCCATAGATAT	CTGCTGGGACTGCTGCATGACT
CCATACATGAGACGGCCCAATCCAGTTA	AATGGAAACCTATCAGTGGACAACTGC
GTAAAACTCTGGCTATTTCCAAACCTTG	ATTCAAAAGCCCAGGGTAAGGGTTCA
GCCAAGACCCTCTGTCTAAGCTCAGT	GATGGCCACTTCATGGGAGCCACCTCTA
TTCTCCTTGTTTTGGAGATGCAGGGCA	CCCTACATGATGTACATTTGGTCTAATGGT
ACCTTCTCACATAATCCATAACTACAGTGC	GAAAAGCAGCCATTGGCACTAGT
TTGTGGCATGCAGCTCACGCTTTGCAC	TAAGCCTCCTTGGACACAAGCAGTTCT
GACATTGGGGGAGTGGCCGTGGCTCCAA	AGCCCGTGAGAAAGAGGAAGAGTGTGAAA
TCTGTGGTCACGGACATGGTCCTTTCG	CCAAGCCATGTTTTGGCTCATTCATG
CTTACCTGCGTTTCATCAAGTCTCTTG	GGCAGTGGGGAAAGGTCACAGTATTCAT
CAGGAGATGGGCTCAGCAGCAGCCAATA	TGCTTAGGACACATGGATTAGATTGTT
GTTTGCTATGTCTAGGTATTCCGATAT	TGAGGGCAACAGACTAAGTCCATTC
TTCATACAGGGTATTCCATAATAACTTTTG	CTTGCTTCGGGGCCATCCACAA
CCACTGCCTGAGAGAGCTCATCCAGAA	GGGCTCCTTCAGATCAAGAAATTGAAAC
CTTTAACTGCATTTTCTTGGGCTACAGA	CGTTTTATTCCTCCATTTTGCAAACACTT
GCAGTCAACCAAATGTCTCCGATTTG	AAGGCAGTGCTAATGCCTAATGGTG
CATTAGTAGCCTGACTGTTAATGGCAT	GTAATTAGCACTTTTCCCCTCCTGCT
TCTCAATATTATCCAGATTGTGTTTCCA	TGCTGATGATGCTGATAATGCCAGT
CAGAATTCTTCACCAGACGCTAGCTT	TTTGGAGGCAGCTCAGAGTTAGAGGTCT
AAAATCAGTTTTTGAGATATGCCCATCTCC	TGCCACTACCACACCACCACCACCAT
CACTTCCCTTAAAAGTGTTGTGTTACTTT	TTGCTTGAAGTAAGCACCATTCATTTC
AGGAAAAAGCACTCTGAATGGTGGAG	ATGACATACAGACTGCAGGGACAATG
CGACCCTTCAGAATCTCTTGCTCTTTG	TTTCAGAAAGCATCGGAGAAGGGCTGCAT
CCAATTTTTGGTAGCAGTGGAGAGCT	GGCATCACTGCCATCAATTCTTCAGT
GATTCATTTCAACTTGGTACATTTGTGA	GTGAAAACGAGGGGCCTTCAATTCAAT
GGGGCTCCCAAGGCAAGCTTACA	TAGATTTCATTTTCAACAAAGAGCAGATTC
AACTCTGGGATGGTTGTGTTTGTGCTGC	TGGTAAATGGTCTGTTTTGGAGAAGTG
CAGAGACTGAGCCATTTTCAAACTCAC	CATTCTTTGGCCAGACTAAAGTGGAAG
GTATTTTGCATGCACTTGATTTCATGG	TTTGGGGGTGAGGAAAAGTCTGGAGTA
TGGGACTGGAGGAAGTACAGAATAT	AAATAATGTGATCCCAAAGCAAGATCTTC
CATGGTTATGTATCAAGTACCTTTGCTGA	GTCTTGTTTCCTGCAAAAAGTTCAGGAT
TCTACAGGGATATAAAAATAGAAACCAAGA	CAGCAAACACAGCAACCCCAAACT
CATTATCACAGCTTGCAGGTGGATTCT	TAGAGCAGCATGCTTTTGAGTGTCCT
GCCTGTATGCACACAGCACCACCAGAAAA	AATGTCAGGGCCAGTCACAGTTTTGA
TCTAGTAATTTGGAAGGTGACTCTATAAAA	GTAAGAGCCTTATGGTCAAATAACGACT
AAACAACTTCTTCAGAAAAGACACCAACC	TAGCAAATTTATCTTCAGATATGGGATTTT
GAGGGAAAAATAAACATGCACGATTATTT	TTCTGGATAAACGCCATGTGTCTCA
CTTTGTGGATGTAGCCTTTATATTTAGTAT	TTTTTCCAGCCTTCACACACAAAGCAG
TATAGTGGGCGTGTTAGAGTGTAAGGAGC	AGGAAACTGCCACCTCAGCAGCA
GTCAGAGTCGAGGGCAAACTCGCTGAAAT	GTGAGAATTGAAATGACTAGCATTATTGAC
CCAATTATTTTCGCGGTTATCAATTTCATG	ACTCCTCCAGAACTTTTCCTGTGGAA
TTGTTATTCAGCCCGTTTAAAACAAATC	CACGTATATGCCATTTCCCTCTACGCT
CCTGCTCCTTTGATAAAATGCAGGG	CAGCAATTGAAGTCAATCACAGAAAGAC
ACCAAAGAAGGCCAAGCTTGCCT	TCCTTCCAATTCCACTTAATAAATTTGTT
GAAGAGAAGAGAAGAGGGAAGAAAGAAAA	AGCACGTCGGGGGCCGGAACCCCT
TCCCAATTTTCTCTTCCTTTTTCTTTTT	TAGTGGTGGTTGCAGGAGATAGAAATC
GTGGACTTGTTAAAATGAAATTGGTATTT	TGGGTCCCAAGCAACTACATCAC
TATCTCAGCGAGATGGACCTCTGGC	CCATTCCCCATTGTGATTATAGCCTAAG
TGCGTGAGAGTGAGAGCAGTCCT	GAAGATGTTTAAAGAATCTTTCAGGTGGG
TGTGTGGAGAGCTCCTTATGTGAGAT	GCTCATCACCACGCTCCATTATCCA
CTGTATTTCTTCCACACGCCCTC	AACTCGGCCAGGGTGTTGAAGCGGCT
CTGGGCGGGGGCCAGTACGGGGAGGTGTA	ACGGAATTGACTTTTCCGTCTTATATC
TTCCTGAAATAATTTCACCTTCGTTTT	TCGTTGGAATATTTGTGCTCTGCCGA
GTGTTGAAGTCCTCGTTGTCTTGTTG	CCAGGCAGCCTGCGCCATGGAGTCACA
CTCTCATGGGTGAACATTTTCCTTTCT	TCCTTCCTGACTACAGGAGGGTTTTT
CTACACATCTTGAACAGCCTTTCTCTT	GAAATTCAACTGTGCAGGAGTGTGTAC
TGATCTGACTTGGGTTTCATCTGTCC	CAGAGGTGTGGAGTATTGTGCTTTCT
TTTTTGTTTCTGTCCCTGTATGATTCT	CCAGAGGCTACATTCAGGCCATCATA
TGCTGGTCAGCGTGCTGGACTT	GCTGGCCGTCCATCTCCCGGAA
GGAGCCCTCCGGGAGTCCGGGGGCTCA	CCTCGGGACTTGCAGTCCACGGGAAGA
CAGCTTCCTCATTCTTTTTCACCAGC	TTGGCCCCATGGGGAACGCAGGAGGC
AGGGGAGAACAGGTCTGACCAGGTGA	GGAAGAAGCTGGAAAGGGCAGTGCCTTA
AATTTCCCCTTGTCCCTCCCTGGCGACTC	GTGACCTGCCGCCGGAGGGGTT
CAGCAAGGGCCCCGCCGAGGAGTCCAGA	AAAGCCACGAGTCTGGTTGATGCT
CCGCCAAGCCGTCGGGGACCCCCATCA	AGCACCGAGGCGCTGTGCCTCGCCATCT
GAGATTATTCTCCAGTTTGTTGATGGCC	TGATGGCGCCGCTGGCGATCCGCTCTGG
AAATGAGGAACAAGTTTGCCTTCCGAG	CTGCAGCACATGCGGGCTCGCCCATA
GCACACTGAAATTAGGACGTTTATATTTC	GTATTTGTGCTTCTGTGTCTGGTAGTG
CTCTCTTTTGTTCTCTCTTGGAACGC	AATAGTGCGATACTAGGAGAGCTGTCG
CTTTTGACCAGTGGAATGCTGTGCCTT	AGTGAGAAGATGATGTCTTCTATTCCA
ACTTACTAGAAGAGGTTTATTTCTCCCT	ATTGCAGTGACACTTGGGTCATTTATC
ATAACCCTCATCCATTCTTTTGTGGTT	CATTTCTCATATGCAGTCAGGTGACAC
TAGATTGTGCACCACACAGATTTATTTTG	GTGTGTCCCAGGAGAATCAGTGCGTATA
AGGCCACAGATTTTGCATCCTTAGC	CCCACGTTCTGCTGCAATGACT
GAACCAGAGCCAGAAGGAATCTGTACA	CTGTGGCTTCTCGGATCCAGGCTGA
TTCAAGCCGGGGCTTCTTTTCGGGAAAG	TCGGGTGCTGCAGAGGATGTGCC
AATCCTTTGAGCAGGCGGCCTCTGCAT	TCATGAGATTATAGAGCCCTTAACTCTGG
TGTCCCGTTCTTAAAGGAAGATGGCC	CGGCAGCTCCACGCGGGACCTC
TTAAGGAAATTATTTGATTCTGTATGCCA	CCACCACGGAGTCCTCCTGCCGGGGTT
TGGCGGCGGGGCCACCGATGAG	GGAGAGAGGACCTGCCTTCTCTGAGAAA
AGCTACTGAGGTTTGGGAGGACAGTAG	TATGCTCCCCATTTAGAGGATAAGGCGG
CTCCCAACTCCCCGTTGCTCCCACT	TCCCATTCTGTCTCTAGTGGGAGATGA
CCAAGCCCTAATTCGTCATCAAATGCT	TCCTCATCATCACTTTCCCAGGAAGT
AATGTGACCCCCAGTTCCACACCTGAAT	GAAACAGCCCAAACCAGAATCCAGA
ATGGCACAGTCCAGAGTGAAGTAAGGC	CCAATGCAAAGAACTGTTAGAAACGAGAG
CCCTCCTGCATTGCCTGGGGATTTGA	CTGACTTTGAAGGTCACCTCACGGA
ATCCCATCTGTCCTTGTAACCAGACGC	TCAGTGCTTCAGAGTCTCCGTTGATT
GATGAGAAACCCAATTGGAACCAATCTG	GTCCTCAGTGGAGGCCACTAACCCACTT
ACCATGTAAAGATCCCATGCGTAGC	TGGTACTCAGTACTGGCCAGCAGTAG
GACAGCATGTCAGAATCCCCACAAGTA	ACCCAGGCTCCTGGAGCACCCCAAAAGAAT
CATAGCACGGACTTCCTTCTGATCTT	TTTCACAGCTATCTGGCAGAAGAGGCTCC
GAAACTGGAAGAAATGGATTCCAAAGAGC	TGGGTGATCAGAGCAATGTTACAGG
ACCAGACATGGAGTTTGTGCTTGGTC	GGAGATCACATTTGGAGATGAGAAACGA
GCGGACCCGATGCCTCTTCCTGCTGAGAT	AGCTACTGGGCATAGTCCCCTGGAACT
CTCAGTTGGAGTTTAGAAAGCTTCCCAT	TTCTCGGCATTTGCCTTAAGAGGACCCC
CCTCTGGAGCCTTCTTCTCTCCC	GGTGGAAAGCATCTCGCTCCAGTGT
CAAGAGTGCTCCTGCCTAAAGAGTAT	TGCTGCTGTCAGTGAACATTTGC
TGTGTGAACTGAATTATATTTCTTCATCTT	CATTGGCCTTTTACATCCATAGGCATC
TTGAGTGTTTGAAGCCGTCTCGTTCA	GGATAGCATAAGTGTCTCTTGACACTG
CAAAATCTGGAGTATCAAGTGGGTGTG	AAAGTGGTCCAACAGCAGTGCAGACA
ACCATCACCCCAGCTAATTTTTAAATT	CAAATATGCCTGTTAATGGTATATTCTGT
AGGCACCGGAATCTCCTAGTCCT	CGCGGCTCAGCTGTTCCACCCGCTT
AAGTCGGTGGACAAGAACAGCAACGAG	AGCTGCCAGAGAGCTCCTTGGT
TGTCGCGGCTCTTGCGCACCGCGATGTT	CATGGTGGTCTGGCCGCAGTGC
GGCGCTGCGGCCGCTGGTGATC	ACCTGCAGCCCGGTCACCCCACGCCGCCG
GGAAGAGGCCGGCCAGCGCCAGCTGCTT	GGGCGCGCCCGGGTAGTCAAAGT
AGCCGCTGGGCGGCATCTGCGA	GTCATGCCCGGGGGAGCGCACG
CTGATGTCGATGGACGTCTCGTG	GAGTTCTCCCGGCATGGCGAGCCT
GCCAGATGCCAGCACAACCCGGGTA	GGTCATGCGTCTACCAAATATGCCA
CCAGCAGAGGTTCTAGACGCTGGA	ATAACTCTCTTCAAACTCCCCGCAAAC
GACGGGCTGCGCCCCACAGCATGGACATA	TACTTGGAGCCATCTCCCTGGCA
CACCTCTCCTGGGTGGGTGTGCTCCTA	AGGGGTGTGCCAGAGCGGCAGCCAGAAAA
CCCAGGCTACTGCCAAACCCCACAACTTA	CAAGGAGCAGAAATCATTACACAGTGG
CCCGGGGTCAGGTGGAGAGAGCGA	CCACAGTGGGGGATGCGGGGTCAGT
TCAGGTGGCCTTGCTAATTCCTGGAGA	TACCACGCCTGAGCCCGTGGGGTCCGA
TCTCCCATTGCACAGCCTCCATCCTTT	ATTTCCACCATACCAGATTTAGAGGGG
ACAGGAGGGTGTGTAGGATGTGACACT	CTCCTCCTGTCCCACGAGCCACACTT
CTGGGGCCCAGGCCAGAAGGCGCCTCA	TAGGGTGGGCACTGACGGACCCACCAA
ACAGAGCCCCTGGGGGTGGAACACTT	TTCATGTGTTAAATATGATGGCCCACC
GTCTCCCCGGGGCTCCGTCCAGGAACCTA	TCTTTGTCTAGGACTCCAGGTCACGT
AGGGTCCCCAGCAGAGCCCGCTGCTCA	AACATAGATCCCGGTGTTGAGCCCTCT
TGTCGCTACCTCAGTTTGCCCCCATGT	GTGCTGGCCAGACCAGGCTGCCCGGAA
TCAGAGCTATTACCCAATGGGGACTTG	TCAGCACCAGGGGCAGCCTCTTCTGGG
CCTCTGGCTGGGGCTCACTCCGCTTCT	ACCGCTCTGAAATTCTAGAGAATGTTATGC
AACTCACTGCCTCCCAGCTCTGAAACATA	ACCTTCTGGAGAAAACGCAACAAAAAG
CCACCTGAATACAGGTTATCAGTGCCT	AGCTATCACTGTAAATCCTCAGACCTG
TCATCAGTTGCACCTTTCAAGGATCAC	TCAGGGTCACACTCTCGGACAG
TTGTGAGGGTTGAGAGTCAGTGAGATG	CTCTGTCTTACTTGTGGAGCCGC
TGCAATTGCATCAAAGCAACAAATACT	AACACGAGTACATTCTTCCCTACTACC
TAATAATGAGAGGAATGGAAAGATGCT	GCCATCAGTTTGAAGCAACTCAAACAG
CTTCTCTAAGGAGCTTCATGACAGACTC	TAGATGCTGGGGATATAACACACATCG
GCTCTTTTAACAACATTTTTATCGGATATC	GTAAGCACTGGTCAAGAAATGATTGGA
CTTGAGATAACTCTGGTCTTTATACTGAA	TGATTCCAGCACATTAATGGTGGGG
CTTCCATCAAAATGAGTTTTAGAACTTTG	AGGATACAGACAGTGATAGGGAAGCAG
CCTCTGCAATAATTAGGCACTAAGTCT	CTTCATACAACTTTCCTTCAGGCTCTT
TCTAGTTGTAATAAATGATAGCACTCTCC	GGTACATTCAGGAGGAAGTGCGC
GGCTCTTTATCTAAATAGAGCCATTCCTTT	CCAACATAGATGGACCAAATGCTAAATCT
CAAGATTGCCTCAAAGGAACAAATTCT	CCCAATTATGTCTCTATAACAAAGCTG
GCTACACAGAATCCTAATAATCAGGCA	TACTTGGACAAAACAGGCATAGCCTAG
TTTTTCCAAGAGAAGAAGCATATGGCTC	TGTACATGTCTTTACCCAGTTCTCCAG
TTCACCTTGACAATAAAATTATCTATGCT	ATAAAAGGACAACCTTAAGCTGTAGCC
AACCAAAAGATGATGATAATTACTACAACA	AGCAGGTTAAAAATCTAGTGTATCCTC
AACTTATTGAACTTAGGAGGGGAAAAA	AACCAGCCTGAATATGATCACCTGTG
AAGCTAAGGCAGCTGTTTCAGAGGA	CCATCCAATTACACAGCTGCCTGCATA
AACCAGGTTCCTCTGAGGATGGATAGA	CAGGGAAGGGAAAGAAATTAACACACC
TCCAAAATCCAACAGGCAATATATACCC	GGATCTACTGCGTATGATTACTGCATG
GAGGTCCCCTGGGAGGGGCGGGGT	CCCCCAGTCCCCACCAGCTCAGTCAA
CCCCTCCCAGCCACCTGTGCCCGCTCCTA	GGGGGCCTGCTTAACCGGCAAGTTCT
CCCTTTCTTGCTCTTCTTGGACTTGT	CTTCATAGTCCCATCACCAGATGGCTA
TTCTCAATTTCATACCTTGCTTAATGGGTG	CAGATAATGGCTTCTCTGAAGACCGT
TGATGCCACCAACGACCAAGTCACCAA	AAAAATATCCCCCGGCTTGTGAGTGGATG
GTGGATCCCCTCTCCACCCTGGCCTA	CCATCTTTCAACCAGAATTTGAACCCC
AAATGGTTTTCTTTTCTCCTCCAACCT	GTAAATCCTGTCTAGGGATATCACACA
TAGCAGGGCAGCTTTGTCCTATTTT	GTGGGCGACGAGATTAGGCTGTTAT
GGAATTGCTTAAGCCGTGTTTGTTG	ATGGATGGATGGTGGAGACGGTTCCCC
CAACACCGGCAAATACACGTGCA	TCTTCACTGTTCTCTCCCATCTTTTGA
AAAAGCAGCCATTTGGGCCACTA	CAGAAGTGACCAATTATTCCCTCAAGGG
TTTTTCCGACAGCACTGACTTGCCCTCCTG	GTCGTTGTCTTCTTTCCCATACAAGGAG
GGCTCTGTCTGCATTGTTCTGTGGA	AAAAATGTCATCTGCTTTTGAATTTGTT
TTTGAGGGGCCACATTTCTTTTCATTC	CTCTTTCAGAAGAGTCTGTCCTGAAAC
ATGAAAGTTAATATGGAGAAGTTAATTGCT	AGAGTTAATGATTCTGGAGTGTTCATGTG
CAGTGATAACAAAATTCTAAGAATCTGTTC	GCTGAACTGATAGTCAACGTTGCCT
ATGGTTTCTTTCTGTCTTATTTCATTCTAA	GGGGATTACACATTACCCCCTTTTCCA
GGTGATTGACTAGTTGTCTTTTCTTTG	TTGTAACAGCTGCAAGGACTCAACTTG
ACTCTGACATATGGCCATTTCTGTTTTC	TGCAATTCACTTGAATTTCAAATATGTTT
GCCAGGGCTTTTGTTTTCTTCCCTTT	GGGGATGTTTAGGCTCTGTCTACCATA
CTTCTTTCTAACCTTTTCTTATGTGCTT	TTCATGGGGTCATAAGGGTTTGCAATC
TTCAGTCATGACTTGTTTCATCTCTCCC	ATGCAGACCAGTTCTGCTTTATGGTAG
TTGCTAAGAAAAATCCTCTCTTCCTCAC	AGCCATAGTTAAAATGCAGAATGTCAT
GAGGGATAGTAAATGGCCCTTGTCTTG	CTCCTAATCTTAGGTTGCAAATTGGGC
ACCAGAGCTCGGATCCCATCGCAGCTA	GAGACTCCAGGTGGCCCTCGGACTCT
CTGTATTGACTATGGGCTTGTTTTCTCC	TTCAACTTGCATCCAACTCCAGGATAG
TAGGTAAATTCGTTCCTTGGGTTTCTTTC	ACTTTGGCTGAGTTGGTCCAGTATTAC
GAGTCATACACAGACCGTCATGCATT	GCAAATTTCTCCCCTCCATACAGGT
TGAAAACACTAATGTAACATAAAGGTAACA	GCAAACATACAGAGGTAGACAGAATAG
ATTTTACATCAACTGCTGTACTCGATCAG	AGAAGTTGCTCTTGTGTTTGGAATTGG
CTCTTTATTCTTCATGATGTTTCCTTCG	CATTCTCTTGCTAGGCCTCTTGGATAC
CTGCAAAGAATGTGTTTTCAAGTGGC	GTCAATTATATGTAAAGTGGGGTGGGA
AGGCCTTTCTCTGAGCATCAAGGGGAAA	GGTGGTGTGGGCTGACCCTCAT
GTTTTAGGAAATCCACAATACTTTTTCTGA	AGCCCCCACGCCCAACCCTCGTG
TGTACCAGCCCCAAGTGGATGCACTTA	AACCAATCATTAATTTATGCTGTCCAGCC
TTTCAAGCATAGTTTTGACAGATAACG	AAAGGACAAATGCAGACATCAGGGATG
ACACATCTATGAAGGTGTGTACTTTAT	GCACTGGAGATTTTTATAGCTTTGACAC
TCCCGAACCAGAGCGACGTGGTG	ATCCCGGGCCCTGGGCCCGGCCACCGTCCT
AGGCGCGCGGAGGGCGCCATGTTGGT	CAGGTGGTAGGAGGGCGAGCTGGCTT
ATGCACTATCCAGGCGCCTTCAC	TACCAGTTCTCCATGGTGGGCGGC
GCCCGAGGTGACCGGCGTCGGGGAGTA	TACCCAGGATGATACCGCCTAGGA
GAGGGATGGACAGAAGAACTGACTTCT	AGATTTCCCTTCCCTTCCACTGAATTG
TGCTGGCCGACCACCCGGGCGAGCTG	ATTCTGGAAAGGGGCCCCCGCAGC
GCGCCAGTGCGTAGGCAGCACGGA	GGGGATACGCATCACAACAAGCCGATT
GGACTGTTAGTAACTTAGTCTCCCTCC	TAGATGCCAGCACGAGCCGCCGCTTCACG
AAGTAGATATTACAAGACCAGCATGTACTC	CTGGGACTCCCCAAGCCCTATTAAAAA
CCAGCCAATCATATAAGCCAACTCCT	TTCTGGGGCTATTTTCCCTTACCTATG
TGCGCTCGAGCGGCCCCAGGTGCGGAA	CCTCTCATCCACCCCGGGGCTGCAA
GAAAAATAAATGTGAAGAAAAGTTTACGC	TGTCTGCATCTGCCTCACCCTTAGATT
AAGACTGGACAGCGGGCACACTTA	TGAGCACTGGAGTATATCCAAAGAAGG
GACAAAAATATTCATTTATTTTGTCCTGGA	ATAGCTTTATTATCTTTGCCTCTTTTCTG
CTCCATTAGTGGAGCAATGCATGAAG	ATTGCATCAAATATCATGTACATAGTAGG
AGCATTTTGAGATTTTTGTCTTTCATCA	ATACATGTTGAAGTAATGGTATGCAGT
GAGCAGATACTTGATTATTAAGGAAAGATT	CTGTACTTCAGGAGATTAAACGAGGAA
GTTTCAGTAACATCAGCATCCTTTATTATA	TTTAATATCAAAGTCTCCAAATTCTGCTC
TACGGCTTACGATTATTTCTCTTTCCT	ACTCAGTCTCTGTTCTTAAATGGTGTT
ACTGGCTCCTGAGCCAGGCCCGCCCTA	GCCACAACCAGAAGGCAGAAGAGGTA
CATCCCTCCCAGGCCCCACTTTCTTT	CCACTCCACTTCTTCAGAAACTAAAAA
CGTAGGCCCAAGTAGAAGGGTAAATCT	GAAAGATGACTGACTGAGTGTGGCCT
ACCACACCCCTGTGGTTGATCCTCA	CTCCTTTGCAGCCTTCAATCTTTGAG
AGTCTGTCTTTTAATTCTTTCCTTCCT	TCATCAGCCAGAGATAACCAATGTACA
GTAGGAAAAGGGCGAGTTCGAGGCAA	CCACATTCTCCGGAGGGGGTCAAGTAA
AGGGATCCAGACAGGGCGGGAGGGCAAAAA	TGGTTCTCTCTGGGTGTGAGAGGATAT
AAGCAGCAGCCAGGAACATGAGCTCTTA	CCACAAAACAACTGAGCTAAGCATGAC
CGCGAAGCTAAGCCTAAGAAAAA	ATGACTACACACCATCAACTCTGAGTC
TATTCTAGAAACAAAAGGCAGCGCCTC	TGATTCATAAAATGACCACTGCTCAGA
CTACTAAGGAGGCTGAGCAGGAGGAT	CAATCTTAATACCAGTGTGTCTCGCTTG
CCATGAGACCTGATATAGATAACATGGA	CCATCTTGCCACATCTTAGAAGTTTAGTTG
TCTAGCTGTTGTGTTACGGACATACTC	ATGTAAATACCTTTGCCAAATTAGAAATGA
CAAAACCCCTCCCCACCAGAGGACTCT	GCCAACTGTTACCTTTTTATATAACAGAG
CAGAAGCAAAGCGTTCTTTACGAACAG	TACTGGAAGTTGACTTTGTCCACCTGG
AACTTCCTGATCTCTCTCGCTGTGA	GCTGTACCCTTTAGCGTAACCTTGCTA
CTCCCCTCTTCCTGCCCTTATTTTTA	AGCTCTGAGGTGGTTTTCACAGGACTT
TTTCTTTCTGCCTCATGCTCTCTCCA	TAGTTAGTGGTTGGTCTTTAACACCCC
TCTCGATTTCCCTTTCCTTTTTCTTTCC	AAGCTGGTCTTCTTCGTGTAAGTTCAC
ATTTGTCGTGATAGGTGACCTGGAGCGGTG	GTGTAAAGGACCTTTCTCCCCAGAATG
CAGGCCATCCGTGGATAATGTGCA	CCACCAGGAGTCCTACCCTCTGTCAGT
ACTGTTTGAAATCCACGGAGTGCCGGG	GTCCCTGAGCTCTCTCAGCCGG
ACAGTGTTTTCTTGCCCTTTTCCTCTG	AATGAAGTCCTTATCCCTGGATTGGAG
TTTTTCTCCCTTCCTCCTTTGAACAAAC	CTATCGGATACCCAAAGCCAATCATTG
AAAATGGAATCTCTTACCTCCTCCACT	AGAGTGGAAAAGGAAGCGACCCAGAAA
CAAGGCCCTCCTTTTACTGAATCCCA	CAGTTGCCACAGACCGTTTATATGAAG
AGGAAAGAGAATACTTGCAGAGGGGT	ACAGAGTTCAGCCTCTTGGAGAGTCTT
AAGTATTCAACGAGTTTCTGAAATTGC	TAAATGGCTTAACAGATTACTGTCGCG
TTCCCAAATGGAATTATTTAAATAGTTGCC	CAAAGACATTCTTTCTGTGAGAAAATACTG
GGGTCAGTTCGATAACCATATAATTTTAC	GTAGTATGTTGCTACAATCAGCTCCGT
AAATTAGTGCAGTTTTAAAATCCTTTTTCT	ACCAAAGGATGCTGTTCTCAGACTGA
AGTTCTGTTATGATGGATCAATGTTTTATT	ACAGCATGAATTATTCTAGCCACTAAA
AATTAAGACTACTGTTTGAAAATTAGGGTT	ATTAGGAGATGAAATTCTTCCCACTTTGC
CTTCTATGTTTGAATGAAGAAGCAAATTC	CACACACTCGAATTCGAAAGTTGACAG
CTGAATGGAAGGTTGGACCAGGTGTCTT	AGTCATATAGGAAGTAGAGGAAAGTATTC
GGCTTTTTGTGAGAACACAGGTTTTAAAAG	ATCTCATTCACTAGCAGATCATATAAGTT
TTTAGAGTACTATGGAAATGATGGTGATTC	ATTACTGATGATACTATCTCAGCTTCTACC
GGTAATACACCAAATTTTATTCCAGAGTTT	GGATACTTTGATATTAATTGGGTTGCAATC
CTAGAAAGCTCACAAAAGTCAGATTTATT	GTTCAGCATGCATTATGTCTGACTTAC
TTAACAGTTTTTATGTTCATTTAGTCACCT	GCAAAATATGTGTGAAGTAAATAGAAGCT
TGGCATCAAATAAGTGGAGAGAGCCTG	CTATTCCCATTTTTACCGTTCCTGGAA
AGTAGTCTTTGAATGATGTAGATACTAGG	TTAACCATTGTGAGAGAATGTGGTATAG
CCTAACAGTTTACCAAAGTTGAATCATAT	AAGTCCATCTTGTCAAAAGTTGTCTGA
ACCTTTAACTCAGTTAACTGAACTTTTG	GCCAAGGTAGGAGAATTTATACTAATAAAG
GCTCTACATCATGTACCCCAGAACTTAAAG	TTCTGGAATAATTCTGACTTATATGCTTC
GGAATTTGCATTTTTCCTTCTATTCACA	GGATTGTCACAACTCATTGTAGCCTTG
CTTGAACATCTTTGTTTCTCTTCCTTG	GATTTGGCAGTATAAGAGGCCTCATTG
TTTTGTGAAGAGGAGGAAATTTGAGTT	CAGCTGATATTCGGAGGAAATTGTTAATG
CTCAAGAAAGCAATTTCAATTCTTCAAAGA	CCTAAAGGACACAGTATTGGTCTGAGC
TTCACTTTTTGTTTGTTTGTTTGCTTGC	GCTATGAATATCCCATAAATTACTTCACC
GGATTAGTGAGTAGGAGGTTTCTGAAATG	GTAGCCCTATCTGCGAAAAACAGGCTT
TTGTTTCCTAGTCTTAAATAAGTGCCA	GGATAAAACCACAGCTATCAACGTCAGTA
CATAGATGAGGAAATCAAGAAAAGTTGAA	TTATCTGGTTTTGGAATGGCTAAATCTTC
TATGGTATGTGTGTTGCTGGTGAGGGG	CTAAATGAGATGCCATAAAGTCTTCTAAA
TCTGGATAAAGTATGATACTTTAATGCTGA	TCAAGAGGACTGGAAAAGTCTTCTAAC
TCATTCAGGGAATGAAAAGTACATAAAAAT	TCTGATTAGCAATGGACTTCACCTCAT
TTTTGAGCTGTCTTGACGTTCACAG	AGTTTATTGGTTGACACCTTCAATGTC
TTCAGTAGAAAAATGGTTTTTGAATTTGGG	ATTGTCATAAAACCAAGTTAAAAAGCATT
CCATTTAAACTTGTAAATGAATGTTTTCCT	GCTGATATAGGCAAATGTTGCTTTAATCA
ATAAAGTGTATTTATTGTAGCCGAGTATCT	GGAGCTTGGGCCTTTGTTCTTCGAGA
AGTGAGCCGTGACTGCACCCAGCCTGG	CCTAAGCCACTTTTTATATCTTTCAGTAA
GTGTTAAAAGCAAGTTACATTTTCTCTTT	GTCTTGCTCTTGGTTTCATTGTCACAG
TGTTGTCTTCATGCTAGTTTAAACTAATT	TGTATTTTTACTGTATGTTTTCTGTTGCC
CTCTTACCTATGACTCTACTGAAATAGAA	ATCTCAATATGACATTCATGGAGAATGA
TGTACTTGATAGGCATTTGAATTGTTT	CTAAAACAGTTCTGTTTGCTGTGGGTC
TTAGAAATTTAATATGTCAACGGGGCATG	CATGTTCAGGGATTTTTCACCAGCTG
CCATAGATGAAGAAACAAATTTAGAGGTTA	GTAGAAAGCAGATTTCTCCATGATTCATT
TGGGACTGAGGGGAGATATTTTTGTTTG	TTTTAGGTGAAGGTGTTGCAAAGTGTT
AATGTGGTTTTTGGGAATTTGTAATTTTC	CTCACTTTACAGCTTTACTCTATGCAG
TTCAGAACAGGAATTACATATTCCTTTTT	AGCACAAGACTGAGCTACCTTGG
CTCATTAAAAGAGGTGTTCTTGTGACA	CTGAATTTACTTACTGGACTAAGCATCA
CATGTATATCTTAGGGTTCTGTTTTTAAGT	TGTAAGGATTTGCATTGATGAAGAGAT
GTCTTGTCACTACAAAAGTTCCTTTGT	AGTGATTTTAGTTTTCAGGAGCCTATC
GTCAAGAGGTAAGATGACATAGTTTTAAAT	TCCTTGAGAAGCTGGGAGTGTTTCT
ATTCATGGTAGTAGTATCAGTAGTAAAAGT	TATTGGCTGGATTAGTGTTTTACTGTT
TGGTAATGCATTATATTTTAAGATTTTGCC	TGAATATGCTTCATCTTTTCATCAAGATC
TTTTTCCCTGGGATAAAAACCCAACTT	ATTATATCAACTGCTTATTAAGTGGAGAAG
AAGAGGTATACACGATTCCTGACATCA	TTCAACTGCTTTACATAAGAAGCGTTT
TCAGTTTGTCACTAAAATCTCTTCATTTT	AGGTCAAAATTGGTTAAATATTGGCAA
GTGTATCTGACCTATTATCAATCATGTTT	TCTGGCTTAGCCCTTAGAGTTTTAGTG
TGCTATTCTCAGATGACTCTGTGTTTT	TTGGGTGAAGTGGCTCATGCCCATATT
CTTCTTGTAGGTAATGTATCCTGTTCATC	TTCCGTTACTTCTGCATGGAAAAATTC
TATCATCCCCCTGCAACTCAGAATGTAG	ACTGGTTGAAAATTTTGGCAAACATCC
ACAAAATCCGTATTTATAATGTGTTTGAC	ATTGTGCACTTAGCCTTTTCACACATC
CTCTTCTTTATTTTCAGAGTGTCTTTTCT	AAAAATAAAAACTATAGGCCGGGCACG
GAACCTGGGAGGTAGAGGTTGTGGTGATA	TGCAAAAGGAAGAAAATAGAACTAGGCTG
GACAAATGACTTAGTTCTGGTTGAGATGAA	GGGACACTGTAATCACTAGATTCTCTTTG
TTCTAAGTGAAGCTTTTTGTTTTTCTTTG	AAATTGCAACTGTTAGCCAGGGAAGAG
TGCTTGGTTCTTTGTTTGTCTTAATTGC	TACAAATGTGGAAATTAAGGCCAGGTG
TATGTCAAGGCATATAAGAATTAGAGATGC	AAAACCATCTTCATGTTATTGTTGGTACAC
GCTCTGTAATTGATTACAAAGGTTAATTCA	TAGAGCATCCTTACAGTAAGTCACGGC
GAAAAGGGTCCTCTACTGTATTTGATTTT	AGCCAACAAAACTTACTGTAATAAATGAT
TTGCCTCCAGATTTAGTTTTAACTGTA	CTAAGTGAAAATCATGACATTTGGATAAAG
ATTATGTGAAGATGATGTGCAGTATCA	GGAATCCACAGATTTATATCATCCAGGCC
TGGTTTTCTGTTGATATCTTTGATTACTT	GCCTCTCTCCTCATTCTAAACAACAAC
GAAATACCTTGTTTCTTAATTTTGTGTCTT	CCATTCCCTCTAAGAAATGGAAATACA
GCATACACGCTCTACCCACTGCAGTAT	ATTTCTGACTAAACCAGAGGTAGCCAG
GTGCCAGCCTTGAACCGATTTTAGA	CATCTCTGTTTGCATTTGCTAAGGCCA
GTTGGGTAGTTCCTTATGTAATGTTTTT	TCTTGCTGTGTTACTCTCTGTAGAGAT
GCTCTTTAATGGCCTTTTAAAATTAAAAGG	GGCTTATTAAAGCTGACAGCTGTCAG
CAGTGATTTCAGATTGTTTGTTTCTTTTT	TTTTGTTTTCAGCATAAACAGTTGTCC
ATTACAGGTGCAAAGAACCATGCCCAG	AGAATACAGTGAAGTTAGGAGGTTTGA
TTCATAAACTTTTCTGAAGTAACCATTCTG	ATATTGTCTTTGAGTTCCATTCCACTTG
ATTAAGGTCAGTAATTGATAGGAAGAGTAT	CTTGTCTCTGGGAATGCAGATTCTACA
TTTTGGACTGTACTGGATCAGCAATTTG	CTAACAACCCTCCTGCCATCATATTGA
CTTGACTAAATCTACCATGTTTTCTCATAT	GGAGCATATGATTTTATGGTAAAGGTGTG
AATTAAATCTAATTTAAGAGCACACTGTCA	CACTTTGAGTGTCCGATCTGTAGATCC
TGAAGAGCCAAACAAATTAAATAAGTAACT	GGAATGCAGAGACTGGAGAATGTATACAC
ACTTTGTGAAGTGTAGGAAGAGTAAAC	TACTGGTGAAGAGAAAAATGAAGGCAT
TTCTGTTACATTGTGCAGAGTTCAGTT	GAGTATTCCATCTCTCTGCTCAAAACC
AACATATTCTCTATGCAATTTTGAACCTT	TATTCTCCACAGGATGAGATACTTGAT
CACCCAATGAAGAATGTAATTGATAATCT	CTACACACAACCATAGTTGATCAGGGT
AGGCATTTCAAGTACTATGTTTAGATATG	AACAAAAGTGAAAGCAAAGATAGATACTT
ACAGGAGAGGGAAGCTAGGCGCCAA	GTGAAGGAGAGTTGCATGTGTTCCT
TAGCCACTCCCTCCTGACTGGCCTCT	AATGTGGTGCGGCAGTCCCGCAAGTGTAC
AAATCAGCCCCCACTGAGTGTCCTCA	GAGGTGGGAACAGGTTTGAATATTCAC
CCACACACATCCCTACACTTATCTCTC	CCACTGAAGGGCTAGGCGGGGCATTT
TGGGGCAAATTCCTGTTCACCTGAG	AGAGACTCTGGGGGATGGAATCAACAG
ACACACAAGCCTTAATATATATGTAAACC	GACATCTGTCAGAGCGTTTTCCATTC
AGAAGAGTTTGGAAGGGCCCCTGGCAC	TTCTCCTGCCACCGCGTGGTGCTTGCCGCA
GTTTTCTGGGAGGGCTCATCTGTAGAA	CACACATAACAGGAAGTCTCGCACTT
GGGGTGCTAACCATCTCACTCTCTTCTA	TGATCAATCTAAAGCATCGTTGCCTTT
CCGCCACACTATGATGTTTAGTGCTA	TCACACAGAAAGTAGTTTGGGTGGAAG
AGAGCAGGTCAAATACTCCCATGCTG	GTTTTCAGAGGTAGAGCCAACTCTTCC
GCTTTAAGAGAAAACAGGGCCAGGT	TTTGCGAGTACACACATTTCTGCAGAG
CCAGTCAGCAAAGGAAATCAAATGCTG	CACTCATTGATGTCCATCTCACAACG
GCTATAACCATCAGATGCTCTTCTATTGTT	CATTCAGACCCCTGCCAGAATGA
CACAGAACAGAAAAAGTTCTGCTTACTC	GGGGCAAAGGACAACTAAGAGAAAATG
CAGTCCTGAGTGATATGTTCCCATAGA	GCGAAGGCACAATCATCAATGTTCTC
GAGACTCAAGAGCCCTAATCAAAAGTAATT	TCCTGTACTCCAGGCTCCACCTG
TCTGGTGGATTCTCCACACTGTACAT	TAGAATAGACCCGCTTCATGACTTCAG
CACCCCACACAAAATTCTCACTTCC	GCACAGGGCACATACAGGCTGTCACA
TGCAAATGCCTCACAGGCTTCACA	TCGGCAGACTGGTGACTTCACTTTTG
CATTGACATCAGTCTCACATTTCTGCC	TACCTCATTGACATCAGCGAGCTCTT
TCCTTATCATAATGTTAAATGTGCACCAG	GGTCGAGACACAAAGCATGGATGAGAT
GCTTCTTGGGGGAATATTGTCAACATC	TCAGCCGGGATACCTATGAGTGCAC
GCAGCGGTTCTTCTCACAGGGGTCT	CTGCTTCCCTTTAGAAGAAAGAGTCCT
AGTGTTCTATCGCAAAAAGAAAATATATGA	CATTCATTCCCACCTAATCTGGGTTTC
TAGCGCCAGGGCCTGAGCCTTTGAAG	TGAGTATCGGGCTGAGGGGCGCTGT
CTCTCTAGCCTCCCACTTTGATTATCTG	TTACCCAGAAGCAGAAGGTGGGAGAA
TACCCTGGTCCCCAGGCTTCTAAGTAC	AAAGGCCTCAAGGCGCTTTCGCTGCTG
TCATAAAACCTCTCTTTCTTCCACCTTTC	ATCTTTGGTCTGGGAGGTGACCAGCTA
CACTAACTGGTCTGGTATTCTCGATCT	CTTCCCTGTCTGGAGTCTATATACACT
TTTTCTTTTCTTTTACATTCCCTTTCCTC	CTCCTACCCTCTTTTTGGTCTTGCTAC
CCCTCCTTTTCTATTTTCTCTTCCCTGC	GTCTTGTGCTGGGTAGGGGACAAGAA
GGTGATTATCACTGTCTGTCTCTCCTG	GTGAGTAGCCTGGTGTGTCCCCATCTT
GGCATTTTTCTTATCTCAACATGTGTTTGC	TTAGAGTGCCAAGACTTATGTGGCATG
AGGCAACAGCTCTTACCTTGTCTTTC	AGAATACCAAACACCAGTCTCCTTTGC
CACCACGTCCTCTCGTTTCCTTACAT	GTGACAAAGGATGAAGAACACAGCATG
GGAGTTGGAAGCGCGTTACCCG	CGAGGTATCGGTGACTAAGCACTGATT
AAGAATGAACTGTAAGGCCTGGACTATG	GAGTAAAGAGGTCTTTTCTCTGCCTCA
ATTACTTACCATTTGCGATCACCTGGA	TTTCCTCCTAGAGGAATGTGTGGACCT
CACCAACTACACTGTGTCCCCGGTCT	TCTGAAAAACTGACTTATATGAATTCAGG
TTCCTCAAAAACATGTCAGTGTGATTT	TGACATCAGGGATTCTTTTAAAAATACTC
GTCACTGAGAAAATTTCTTTATTCTTTTGC	AGCTAACTGACAATGACCTGGTGGCTT
TTTTCCGGATGCCATAGATACGTGGA	GGTGTCCTCTTTTCTCACCTTTCCCTT
AGGAGCAGCTGGGGGCTTGGCTG	TTGCTAGGGTCAGATTCCCAGGGATGG
TTAAGCAGCTCCCGGCAAAGAG	GCGGACAGTGAGAAATGGGTGG
GATCTTGATCTCAGGTGGACATATATAGT	TGAGCCTAGTTCATCCTCCTCCTCTGG
GCTAAGAAACCCCCAAAGAATTTGGAG	CCATTTTATCCTCAACTTCTTAGGGTC
GGCAGTTTGAAAAATACAGGAATCCAG	CTGTCCCAGGAACGTGCCATGTGCTT
ATGGAAAGAACAGGGAATGACCACAGG	TCCTCTTCTCTTCCAGACTTCCTCCT
TGAACCTGCAGTCTGGGCACAAGAAGTATA	GATCCAGCTTCACAATGCTGCCCTGAA
CATAGCTGATACAAGGCAAGCTAGAAAA	ATGTCTAGCTAGCAGGCAGAGAAGAT
AGTTTGCTTGCTCAGACGATCACTTAG	CAATTTGACATTTTTGTGATATCCAAGC
AGGAAAGCTCAGTGTTGGTTAACTAGA	ATGGTGGACCAGCGACACACACTTGAC
CTTCATCAAAGATCGTTTGATAAGCTCTG	TAGGATAACTGCACACAATGTGTATCT
TGCTGGTGCTTTGGTTTTAAGGT	CTGAAAGTTGGAAATGAATACCGAAATGAA
CCAGAAACATTCAACTCTCCATTATGAC	TCTTGAGCCCGTGGCTTCCTTTGCAAA
CGTTGCACTCAGCAGAGCTGCT	TCTGCCAGACTCTGGACTGATGAAGCA
CTTGGGAGGTGTGGCTCCATCCCCAA	CCTGGATTGGGTCAAGAATGCCCAGAAA
TTGGTTGGATCCAGAGAGGGTGCCTT	GGTATGGTCTGACTTATCACATCTTTT
GAGTTCTGCCAGTAATCCTGAAAATGAC	CAACTCTGAGGGGAATAAGAAGGATCC
TGTGCACGTTGGAGGTGTCATGACCA	ATGGTGATTCCAGAAGCCAAGGCTTT
GAAGTTCCCTCATGAATCGTCTCGA	TAGGTTTTGGTTTGCTGCAAGTCCAC
TCACTCCAGTCAAAAAGAAGCGGG	GATGAAATTTCACAAGAAAGTTGGAAAGC
CTTGAATCAGATCTTGTCCTGTTCCAGC	CAGCCATCAAGCACCCCAGGCCTGTTT
CAACTCTGAAAAATTGGTTTCAGTGCTG	CTCTGCTCTTGGCTTCCTGCCC
GCTATGCACCCACTTTCAACACAGTT	TGTGCGAGATTGGCTCCCTAAAGGAAA
GTCCAGGGAGCAGAAATCAAAAGAGTAC	GTGGAGACAGCTTCCAGGTTCC
GAGAAGAGCTCAGAATCCCGAAGGA	CTCCAGTTTCTGGCAGACCTGGA
CTGAAAGCTTTGGGGTTGTTATTTTT	CTTTGGGTTCACCCCAAGCAAGATGAA
TCTATAATCTTTATAGCCAAGTAGAATGCT	CCACCAAGAAGAACCTGGACCACGTGAA
AGGTCGATGCATTTTTCCAGCACC	GCACTTCGCACTGGATGGCTTC
TGAGGACTCCAGAGACCAAATGC	CCCCCGAGGCGGAAAGAGGAAACACAAA
TTCCCACGTGTCAGTTCCCTAGGCC	TCTTGGGTAGAGGGGGTGGCGGGGGCA
TTTCCCTCCCTGGGATCCCTTCGCTTA	TTAGACTGGGTTTAAAGGGTCCCACT
GCCTTTTTCTTGTCCTTTGCCAGG	CTCCCCTCCATGAACAGGAGCATGAGA
TTGGCCCCAGGAACCCCAAGGCCCTTA	ATACATGGGGACCAAATGCAGAGAC
CAACAAGCATTTATTGAGCACCCACTG	AGTGGGGCTGCCAGGTGCCTGAGTGA
AAAGTCATGGTGGAGGCCTACCCAGGC	TATGACCTTGAGCAAGTCCCTGCC
CCAGGTAGGTCCAGTTAAAACCTTGCA	ACCCATTGATCCAGTCCCTGAGCA
GACTTCACCTTGTGATCTGCAGGGACT	TGATAGAGATATTGCTCTCCTCCCTGC
AAGAAGTGAAAGAAAGAGGACATCCCAC	TGGCTCTGAATGAACTTGGCCCT
ACAGGAGGTGGTCGTGTTCGAGGAC	GCAGGAAGGTGATGTCCATCAGC
CAGACAGGGCAGTAGTGCGTCCT	CAGTTCAGCGGATGCTTCAGCGT
CAGGTCCTTGCTCATAGCCAGCACTCA	GTTGTTGGTGCTGAGGATGCTGCT
ACTTCTGTCTGCTGTCCCTCTCTCCCA	CTACCTTCCAAAACACGGGGACC
AAAAATGGCACTAAGGTGCACCCA	CACACTCCTGCAGGATCCCTACCGACT
CGTTACCAAAAAGTCCTGACCCTCA	ATGTCAGGGAAGGAGACCTGCTGAGGA
GCATGTTGGAAATCTACTTGATCGAGG	GCTTCACTTGTAAAATGGGGCTAATAC
CCCAACAAAGTCCCCCACCCCC	ATCCTCTTCTTCCCCTTTTAGCTAGGC
TGAAAGGCTCTCCTTGCAGCTGCTTA	TGACTTGTCAAGATGGGAGAGGAGAA
CTTTAGGGGATAGCTCTGCAAGGGGA	CGTATTTCTACTGCGACGAGGAGGAGAA
AAGGGTGTGACCGCAACGTAGGAGGG	GGTCATAGTTCCTGTTGGTGAAGCTAA
TCGAGCTGCTGCCCACCCCGCCCCTGT	GACGACGAGACCTTCATCAAAAACATC
AAGCTGGAGGTGGAGCAGACGCTGTGGC	ATGTCTCCTCCCAGCAGCTCGGTCACCA
GCTGGCCTCCTACCAGGCTGCGCGCAAA	CGCCTTCTCTCCGTCCTCGGATTCTCT
TAAGAGTGGCCCGTTAAATAAGCTGCC	TGGAGTCTTGCGAGGCGCAGGAC
GGGGAGATAATTTTGTCCAGAGACCTT	CAGAGTCTGGATCACCTTCTGCTGGA
ACTCTGACACTGTCCAACTTGACC	CAGAAACAACATCGATTTCTTCCTCATCTT
ACAACTACGCAGCGCCTCCCTCCACT	TTGCCCTGCGTGACCAGATCCC
GTTCCGTAGCTGTTCAAGTTTGTGTTT	TCTGGCGCTCCAAGACGTTGTGTGT
CTTGTTGCGGAAACGACGAGAACAGTT	TAATGTAAACTGCCTCAAATTGGACTTTGG
TCATTTCACTTGTATAAATAATCCCTCAAA	GCTATTTGAGTGAAAAGACAAGAGTTG
TTGCAATGGGTAAGATAAGATTTCTATTT	ACTGTGTTGGTATTTCCCAAACTTCAG
GCCTATACATTTTGTTGGTTTTACATTTT	AAACAGACAGTTCAGAGAAAAATCCTAGC
TGGATTGAGTATATTTTCAGATATGCTAGA	ACCAGGCTTCTACTAAAGCCCATTT
GCAATCAACATCAATGCCTTACTGATT	AGTCTACTAACTGCCGGAATTATTAATG
GAGCGTATTTTCAATTGACTTAGAAAATTT	TCCAGGATTGGAATTACACAAGTCAAA
CTGCGCCCCGATCGCGCCCAAC	ACGCATGCGCGTAGGGAGCACGTAGT
ACCGGGGAAGGAACTTGTATGAACTT	CAAGTTATTTTCTGGAGAAGCAGAGGC
CTGTTTGCAACAGCTCTATGTCAGCA	CTACTGGCTGCTGTGCATATATTAGAC
CTGTCTTTGAAAAGAACATGAAGTTTTTA	GGAATATGTCAGCAGCATGACATACAC
TAGCAGACATAAGGTAAAAATGGCATGG	GCACAGAACCACACCCACTCTCTCAA
CTGCCAGACCTGGAGGGGCGGG	TGGCTCAGGCAAGCGAGGAGAGGATCA
CGCTGATCGTCGTGTATATGTCTTAATC	GACTTCTGCCCCCAAGTAGTTATTTAG
TGCAGCACTCAGTTTAATAAAACATTT	TTCTGTATAAAATCTTGTACCAAATAGGTC
TGCCCATTTCTTTTATCTGATTACATCA	CTCTCATGAAGAGTTGCCTATCTTGGG
GAAACAAAGTTACTTTTTCTTCCCCTT	AGTTTAGACATAACACCAGAGTTCCCT
TTTATTAGTCCTGTGTTTGCACCATTT	TACAAATGGTATTCATGACCCCTGTGG
TCCACCAGTAAAGTCATGGTTATTTTC	TTCAAATGTCCGTCATCAGACATCTGC
GACTATGACCCTGACGCAAGCCT	CAGCTGGGGTCAGGCACGCTAGCACTCTAT
GAAAGTTATATATCCAGTGGAAAAATCCC	AACCAGCCATTCATCAAATGTTGTTTG
CTGTAAAGCATATCATTTGATTTTTGGTT	GAAACCCAGTATTTTCAAGTGGTGAGG
CAAGTAGATGTCTCTATTAGCTTCCCAGA	GGATATGCTAGAACTATTTTCTACTGTGTA
TCCAAGAGGAAAGCACTGCAACTTTC	CCACTCCTACAAAAGAAATGGGGAATCC
TGCCACGACTTCGGGACCTAGAG	TTTCTCCTTCCCCGCAGCCTGCTG
CTGCCTGAGGTGGGGGAAGGAGGATCATT	GCCCGTTGTTCTCACCAATAGAACA
GAAAGTCAGCCATCTGGTGAGGCA	CACAGCATGGTCTTGTCCTTGAAGAA
ACTGATGAATGTGGAGGTTGCCCTG	AGCAAGAGCTGAGCTCTTTTGCTGT
GCTGGTGGCACCAGTTCGCTGGCACA	GACAGAAACAGCAGCGACGCATGTCT
TCGCCTCAAGAAATGGAAAGGAGTGC	CTGCCCGTCTGCTGAACCTGGA
CTCCTGCCGCCCACTGCCCTTCTGGAT	GGTGGGAAGTTCAACCAAGGGCTCAGTA
TACAGGAGAGCCCCGCCCCAGA	TCACCTCTGCCACTGGCCTCATCCC
CAGCCTACACCTCTTGGGCCCTGAACT	CTATGACGCTACAACACTGATTTGCG
TGTTCAGTGTGCCAGGTCTCACTGTAT	AGTGTGAACCCTTGGTTAAGATGAAGG
ATGGGAGGAATAGGAGGCATCTCCTTA	TACACACTTGAACAGAAGAAGTGACAA
CCATAAAAATAGCAGTCTGCCAGGGT	CCTCCAACACCAAGGCTGTCACCACATT
ATCCTCACTCTCCACGTAGGGAGAGGG	CGATTTCTTCCTCTTCATCTTCCTCTTCAT
GCGAGCTGATCCTCAAACGATGCCTT	CAGAAACCACAACATCCTGGAGC
AAAAGCTGGTGCTCCTCGGCCTGGAGGGAG	TTTCGGGGGCTCAAGCTCTTAGCCTTT
CATTTTGAAAAAGGCCACTGAGTATGTCC	TGTGTTGACATTAAGAATGTTGGTTTAC
AAGTCATCTTCGTCCGGGTAGAAGCAGG	GGCGCCGACCTCCAACACTGCA
CACCATGCCGGGCATGATCTGCAAGAA	CCGAGCTGGGTCACGGAGATGCTGCTT
TTCTCGCTCACGGCGCGCTCCAGCTTCT	ACGGCTGGGCGACAGCGGGGGCGTG
CCCAACCCGGTCATCCTCCAGGACT	CGCCGTGGTCTTCCCCTTTCCCGTGAA
GGCCGCCAGACCAGCGGCGGCGACCACAA	TTTCCCCCAAGTCTCTCCTCGGGGTAAA
TGAATAAGACCATTTCTTGAACTTTGTC	CAGTTGTCTCCTTTAAAAGCAACAGGC
CAGGCTGAGAACAAGACACATCACT	AGATCACTGCACAATGACCTTGTAAGG
GGAGCACCGGCCCAGCCCCGATGTGGA	GGCGGCATAGGGCGAGACTGGGTGGTCT
TGACTGTCCGGAGATTCAGAAAGCGG	TAAGAACGCTGGCGAGACCCTTCTGCAGCG
ATCATAGTCCGAACTGGGCTCCG	AAGGAGGGTTTGGGGGAAGGGATTTCATT
GGAGTGACGTGTGGTGTGGGGGA	TTGGTTTTGCACAGTCTCTTCCCGGAT
CTGCCACATCTTCGTTGAAGTCAATTG	CCTGCCAGGTTTCTCTTCAGTGATGTTA
GCATTGAATTAACAGGGCTCCATCCTAA	TGGTCGGAAGAGTCTCTTAAACCCAG
TCTCTAAGGTGCAGCAAGTGGCGTTGTTT	CTTACGCATCACTAATGGGGTGGG
CCACGGCTTCCCCTCACCGACTCTGTCTA	CTGCTGTCACCTGAGACTTTGCGTTT
AAGCACCGTGATCCCTTTGAAGCCCC	AGAGGACCCTCTGCTGAAAGCCAAAC
CTTCTCCACAGGAAGATCTTTGTCCTC	CTGGGGTCCTCACACATGGTTAGCACAAAA
CTGGTTGCCACCATTCATAAGGACAA	CAACCTTTCCCAGTCGGCTGGGCTGAATTT
ATACTTTCCTTTAAGATAAGGCAAATGAA	AAGGAAATCAGGACAAAAAGCCAAAGT
TTGGAAATGAAATTTAACTCAAAAGGTTT	TTGCAAAACAATTTGGCTTTATTCATC
AATCGCCAACTCAGCGGGTTACGTGGG	TTGGTGAATGAAGCTTGTGGTAATTTG
CTGAGCTGACTGGAATCTGCATACA	ACACAAAATGGTTTGGGATCCTCTTGG
CTTATACTTTCAAACAGCCAGTCTTCA	ACCCCCACCTATACCAAAGATGGAGC
GCAACCCTAGGTTCTCTTTGTTGGTA	GCTGCAAAGCTGGGTTTGGACACGTTT
TAGCAGCACCAAGTTACATCCAGATG	CAAGCCCTCAGTTGAGCCGGCC
AACAGTCTTCCCTTGATTCCAGTTGG	ATCAACATGGGATGCACCATGCCCAA
TTACATGGCAAAGGACCTGTCTACCCTCA	AAAGAGGAGAAACCAGAGAGGAGATCC
AATGCAGATGGCACCAAAACCAGCAGG	AAATGAGGCATTCAGGTCCCCACCAATTCC
GAGTGGCCGGGGGCTGGCCCACGTGCTGAA	TGTGGTATCGCCCAGTCCAATGCCTT
GAGATTCCGAAAGAAACACTATCTCCT	CGGCACCGATGCTGTCATCACT
TGAGGGAGCAGTGCTGATGATTTCA	GTGGCTTATCTGTGACGTCTTTGGTA
GGAATCAACAGGATTCCCAGGGCTGA	AGAATACAGCGGCTGGGCCAAGCTGTA
CAACATCAATGGTGCTAGTTATCTGCG	TACCTGCCGCCACCTCACTACGTCGGTC
AGGGTAGATGGCTGGCGTGGCA	TCCAGAGACGGCAGAAGCCTCCACTGT
AAGGGCTGCGGGTCCCGGGAAAC	ACAAAACACCGCCTGGAATACAAAAA
CCAGTCCACACAAGCTAGAATAGACGA	GTTCAACATGCCATCAGCCTTAACATC
TGGCATCAACAGAAGCTATTAATCTCT	AGCTGTCAATGGCCCATATTGAAAGTC
CTCAGGCCCGGCCCAGATGGGCGCATT	ATTCATAAAGGATGCAGATGGGGAAGG
TCATATGTAATAGTGTCCTTTCTTTACAGA	TAACAGCTCCTTACTTTCAGGGTTGAAG
GGATGTCCTTAAGAAATTGAAAATGTCCTC	ACTCTGCTGGGCTCCTCTGTAGAGTG
GTTTGGAAAATTGCAGCGAAATATGCG	CACCCCTCATTTCTCACCATACCTACT
TTCACCAGTCCTCTTCTGCTTAAATCA	AAATAAGATGGTAGGCTGCCTTTTGTC
GACCTCAGACCTGACCCTCTACCTCT	CCTCTGGGCTGGGCTGCAGAGGGAT
TCCCCAAACCACACATCACTCCA	AGTTGGGAATTTGATTCACTGTGCCAC
ATGGCAGACAGTGACATGGGAAG	CCCGGCAAATGTGGGACACCAATGA
CTGATAGTTATACAACTTTGCACTGCAG	TCTTGCCCAACAAAGTCCAGGGGATCT
CCGCCACACACACCTTCTACAATA	AAGGTTCCTGTTCCTGAGGCGGTGCTC
CTCTTTGCTCATGGAGTTGTCCCTGT	AGCTCAGCCTCTCACTCAAAAGACCTT
TGTTATCCTCACCCTGTATCACCTCCA	TCTGATTCCTGAACTTGTGAGGACATC
TTGTCTCACTGCCTGCTCTTCTTTCA	GCAGACTCAGAAGTCATTTGTCGAAAC
GTCCTAATCCCCTATATGCTCCCCTTA	CACTCAGTAGGAAGGTGGAGTTCTCCA
GAGTTTTGATTTTCTGGAATTCTTTTCCCC	ACCAGAGGGATAGCTGCATACAATAGG
TGAGTTATAATGGGAGACATTGATGGTCG	GCACTTTGAAATCACCACCATGCCCAA
CCTAGGAGCCGAAGTAGGTCTGG	AAGCTTCAGCCTCTTCAAGACATCGGA
ACTGTGGAGCTGGTGCGGTACGA	CGCCTTATCAATGCCAGCATTAGC
TGTAAGCAAAGTACAGCATGGACACAG	TACACCCTCTAAGTCCCGAAGTGC
ATAGATGCTCAGACCAACGGCGCCCTGTGG	ATGGTTCTGTGGGTTTCACTGGGGTGG
TGCCCTTTAGACAGAATTTATTTCTTTTTC	TTTTGTTGGCCTAGTAGTGCATTTCCC
TCTTTTCCCATCCTAAGAATGTAACTGC	GAATGGTGGTAGAGTTTTTGTTCCCTC
TGCTCACCACAATCTATTCTTGCTTTC	CGAATTTAGTGCCCAGTATCCCTATCT
TCACTTCATCTATCAATGTTCTCTGATTTC	TTTGATTCATCCTGTAACTAGGGTCCC
GAAGGGTTTTAATTCTTATCTTTCTGTCAC	CTGATTGGTATGGTAAGCCTTCTGAGT
GTGATATAACTTAACCACCTCGTATTTTT	ATGTTGTTCTTCCCAGTTCATTTGTAC
CTCTGAAAGTGTGGGATTACAGGCAT	GCAAATGTCAGAAGTTAATATATGGTGTG
GGATTTATTGGAGAAGAAAGGTGAGAT	TGGCGTGTTAGTACGGCAATGTCAAT
TCCTTTCTCTTTAAATGAGAATCTTTTTCA	TGAATTCACAAAAACTGGATTTGAACT
CTGTTAGATTAGTTTCACCATACTTTTACT	TGACCAACTTGGTCACCATTAATTAGG
CCTTTACAATTGAAAAGAAATGATGTGTT	CCACTGAGTCACTCTGGGCAAGTTATT
GGCACTAATTATGCATCGTTTTTCCTTCC	TGCACCTCTCATTCATGAGTTATCTCC
TAAAAGCACCTGTTACTGCTTATTTCT	CTACAGATCATATCGAAGCTTTCACAT
TACTCCTTTGTTAGATCCTTAGATATGAAA	AGGTTCGAAAAATTTTGGAAAAGGGGT
TCTAAGACCACATTGCTCTTTTTAAATTT	ATTTGATAGAAAAATCTTACTTCGTGCA
AAGAAATAAGCTAACTCTTTCTGACTTTT	TCCATTTTAGCCATGAAACAATTTTGT
TAAAATGTACGCTCTGTGTTGTAGACT	TGTTCTAAAACTTACCATGCACTCTGT
CTAATTAGCTTACTGCAGTAGAGGGGC	GCTTCCAAAACATCTGTATCTGTGTGC
TGAAAACATTTTAAAGAAATGCTGAATTGT	AGATTGAGCAAAGCAGAAATATCTTGT
AAATATAGAAAGTTGGATTCTGTTTCTGTG	TGATTCTTCATTGCAGTCTGAGTTGC
CTGTGTTTCACGTTTTTAAGGATAAAATAT	GGGTATACACTAATGGCTCTAACATGTCA
GATGCTTAATGTTTGGGACTTTTTCTCC	CATGGCTGCCATTGAATTCTTTAAGGG
TGTCAAGTAGTTTTAAGAGATAAAGCTCT	GTAGCAGTTGAAATTGGGCAAAGTGTG
AACTTTAACATGCTTTCTTTCTTTCCA	AATCTAGCCCTTTCATTTGGAATAACT
ATTTTCTATTCCTCAAATTAAAAGCTTGGC	TTTCTTCTAAACTACTTCGACAAGACA
GGAGGAAAACTCACAATATTAAAATAGAGT	TTCACTCAGAATATCAAGAAATGCCAA
ACATTGTTCATTAATGTCCTGTAAGGCTG	GAAATTCTTTGCTAGCTGGTGGTGATG
CAATTCAGTTGGTAAACATTAGGGATAAAT	GTAAGACATCAGTGGAAGCCACACA
ACATTAGTTCAGATCTTGACTTTGTTTTA	TACTTACCAAGAGAAGTAAGTTTTGCA
GCTAAACTAATGTCAACTTATTTCCTTTTT	AAACAGCTGGATGTGAGAAAAAGAGGC
CATTGAGGTGTTCCAGAAGATGATAAAG	TTATATCAGCACTCATCAAGGCTCTGT
AGATTTTCTCCCCTCTCTCTCTCTCAT	GGGCAGTTTTGTTTGCCTGAATAAACG
AGGAGTCCTCCCCCAGTGTCCA	TATCATTAGGAGTGCTGCTCGGAGGTTA
GGGGGACTCTTCGATCGCGACCTGGATTT	GGCTGCGAGACCTGGAACGACT
TTCCGCCGTCTGCGACCCGGGAGTGGC	ATCTCGCTACAGCCGCTCGAAGTCTCG
CGCCCCGTCCGGGCCCGCACCACGTGCTT	ATTTGCACCCGCAGCTCGCGGC
ACACGCTGAGGCGCGTCTTCGA	ACACCACAGCCGCCGGGGACCGCCACCCC
ATGTACACGTCGCCGACGCGCCCGTACTT	ACGCCGCGCCTCTCAGGCAGTTGCCTT
CAGTCAAACAACAATTCTTTGTACTTTTT	GGATCACAGCTAGGTGTCAGTGTAAAC
TTCATACTTTCAGTGTATTTTGAAGTGAT	CTTGATTTACATTCATGTGACATTGGA
ACTGTCAGCTGGTTAAAACTGTTTCCC	ACGACTGATCAGTGAACACATTGAAGC
GCGTGTTCCGATTCCGTCCACAAAAATA	GAAGACAAAGAAGACACTCGATGCTAC
CACACATGCGTGCACACACAATCACAT	CATCATGGTGACAAAGTTAGAAGGGTCC
TTCTCCAGGAGCCCCTCAGATG	TTCGGGATGCCTCCAGCTCCCCC
AGGGGCACCATAGTGGGGTTGCCTT	GCGAGGGGCGCCTGCTCCTTGCTT
TCTCAAAGTGCATTTGGATGCAGAACG	AAGGTACTACACAGAAACTCAGCAGAC
TCGATGGGGGCCCTGACCGCGG	AGTCGGGCCGAGAGAGCGCGAGAGGCG
TTCGCCTCGGCCCGGCCCAATCC	AAAAGCAGGTGCCGGTGCCTGTCCCCGGG
AAACTTCAGCAGCATTCTGGGATTAC	GCTGATGAGAAGTTGAGAGGGAAGGTT
CTCTCCTCTGGGCTGGATACCCT	TGGGCGCGTGGATGATGGGCGGCAT
AACTGTGTGTGACCTTGGAGTCCAACT	AATCAACGTGGTGCCCATGCCTCCCTCGG
CAATATCATAGAGTGCAACTCTCCTCA	AAGTCCAATGCGCATGTGTTCCT
GATGAATGATGCACGCATGAAATACCA	TTGACCCTCGCTGGCTGGAGCAGCGGG
CGAGGGTTGGGAAGCAGGCCCTCCCTA	CTGAGCCTGGCAGGTCTCTGGGT
AGGTCATCCTGCAGGCCTGCCCA	AAAGGTATTCCTTATCAAAGACCCACC
CATCTGGAGTCACTCCTCACAGACCTA	CTGAAGCAGGGTCTGCTCCTGATGA
ACTGGTTGCAAGAAATGCTATTCAGTT	GACTTAGGGCAAGTTACTTAACCTCAG
CATTTGCTCAGAGGCCCCATGGAGAA	GCGCTGCTCTTTCTGCATCAGCT
AAGTAATCCAAGAGACCATCGTGCCC	CACAGCCTCTTCAACTACTTCACGAA
TGAACTCAAACTCAGGAGGAGGCTCTT	CACTAGCACTTGGTGTGAGAGAATTC
TACTACCGCCACAAGGTCAGCGA	AGAGAAGTGAGGTCGTTATCCCCAT
CGGCTCCTGAGCCTTCCCTTCCTTGAA	TAGAACACTGCCCATTGGAACGTCCTT
ACCTCTGACCCACCCAAGTAGCTCTGTTA	CAGGTTCTCCACTGTAAAACTCCTCTAG
CAGGGACTTGACAGCAGGTTCCTCTT	TTTGCGCTCTGGACTTAGCAAATACAG
GCTGCAGGCTGAGGGGCGGGGGAGAGGTA	GGCCGAGCGAGTTGCGGCCGCGAAGGTA
CTCACCCAGCCTGATTTTCTATTTTAAGG	GATAAATAAGCTGTTTAAACTCACGAACT
GCGTTTTCTTTAATCTGAAAGAAATAGCTA	AGTCCGACGTACTGACGATACACCTGT
AGATCATGATTTGTATATTAACACACCTGC	TTCATGCTGTTCTCCAGTTGTTCATAAC
TGACATACGTGTTTGTGAAAAACAAAA	CAACTTTTCCTAAAGGCGCAGAAAATT
ATAGTTTCTTGAAAAAGGACAAATTAGCC	TCTGAATTGCAAGCAATGTAGCTCAAAG
TGCAGCATATAGACTTAGATATTTTTCTGA	GGAGAGTTTATCTGCAAGGAAAATGACTG
GGCTTGTAGAGAATTAATGAAATTTTACC	AATATCACTGAAAGGTCCAGGATCTCA
TTCATGGAATAAGCAAATACATAAAAATGC	AGCTATTGGTGGTGGAATCACTTCCT
TGGCATATATCACTCCTTTGTTTTACTATA	TTCGGTCACTCTGGAGACGCTACATCA
TGGGTAAATGAATGAATGAGTTCTATAAC	GAAGGGTAGGTCGACGTCCCAAAAGTCTTA
CCAAGTGAACTCAAATGAAAACATTCAGA	GCAAATCACAGAAAACCTTATCAAGAAAT
CTAGATCTTTTCTCTTGCTTGCTTCGT	GGAACAGTTTATGTTTGGAAGAGTAAATT
GCAGAGCAGATTGGATCCTCACCA	ATTGCTTCAGGGTCAAAGTGCATGCT
GACAGTACACATCTACCTGAGAAGTCG	CCCTATACTCAGGGATCCCAGGATTC
ATAAACTCCAGAGGTTCATAGTAAATGCTC	ACCAGCTCTCAGAGTGGCTGCCT
TGGCGTAAGCGGATGCTCCTCAC	ACTGGGAGCGGACTAAGTTGGACCTA
TGTAAAGAGAGACCCAAAATCATATGGACC	GTTTCAAAGCCAATATAGTGATCGGTGG
CACGTGTCCGAATGACCAGGTG	TCTGCTGCAGAAAACGGACAGACGAAT
CTGTGCAGGGCAGGAACGCGGTGCAGA	CAGTAAACCGTAGCTCAGAAATCTTTGC
CATGGTAAATAACAACCCTTCTGATAATAC	AGGGTCCCTTATCAGAGAGGAGCCAGT
GCTGAGAGAATGAAGGCTCTAAATCCC	CCATCGCTCACAGGAATACACAGATTT
GGGTCCTATGACTTTTCTCTCCCTCAA	GATGGTTTTACTTGAGCATTGGGTTGG
CCTGCTCAGTATCTCTTCCTTTACTCA	CCTCAGAAAACCCTGTCAGTTTAGCT
GGTTGGTTTCTGTCTTCTTTGTATCCA	AGCCATGTACTCAGCTCTTCTAGTTTC
CTCACCCTGATCCTGTGGCTCCCTA	CAGCTATCCCTTTCCCTTTCTTTACTGG
ATGCCCGCGGAACCTCCTGCCTGTCTTTA	GCCCTAGAGCACAACCTCTTCACCCATT
AGGCTCCATCATGGCCTCCCCCGC	GAGCAGCTGGGCCGGCTCAGCCCACC
ATGCTGAGTCACCGCCCACAAGGCCC	TTCGGAGATCACGCCACTGCTG
CTTATAGAGAAAACGAGTGTCTCTCTG	GATGGGAGATGGGCACAAAGATAGAA
ACACTTCCCACTATTAAATTTATACGATC	TTAAAGCCTGGCCTATTTAGTCACAGT
GGCGAGGAAATGCTGAAAGGTCAAA	CCCGTTGGAGTCACACTGGCAAACCTT
TACATCCTGAACAATGCTATGTGTTTT	ACTGCACAGATGTGGACAGGATTGTGG
ATGAAGCACATAAAATTAACTTTTCATGCC	CTGGAGTTTCGCAAGTCTCTGCCTCTT
GAAGGTTAGAAGCTTTGAGAATTTCACCA	CCCCAATTCAATTAATATTACAGCACTTG
TACTGTCTTTCATCAACATACAAGAAAAA	TACAGGTTTAGTTCCAAATGCAACTGG
AAGTAGTTTTGATTGCAATGAAAATTTCT	ATCTTAGGATTGGGGGCAAAATAAGGG
CCTGCAAAAATATGGCTTCCCTTTTATTTT	ATTCGCCAAGAAGAAGGGCTTCATGCC
ACCCACATCTGGAGATGTCTGAAAGA	ACTGCGTTCCAGGCTGGTGTAT
ATCTAATGGGGCAGTAAAATCGGACGG	TACAGAATCAGTGGCGGAGATCCTACT
AAAGTTGTGTGAGTGACAGGCTGTAC	CTCTTTATAATGCAAGGAGAGCATGGC
AAACACAAATAGAGTTTTTGGTTGGCT	AATGAATGGTTACCCTTCATTCCAGGG
ACTTTCCTCAAGTCATCTTCAAATTATTAT	TCATCATAAGGCTACAAAAATAGCAAG
AATACACAGAATTATCAGCTGGTTGGA	CATTAAGTGAGAGACTAAATGAGCTCA
ATGAAAACAGTTAAAATTGTGCCACCT	AATACCTGAAAGCATAGGAATCACAGT
TGACCAAAGTTGATACAAATGCAAATAGTG	TCTTGGGCATATATCAGGAACTTGGC
AACCTAAGCAGGATATAGGTTTAAGTATT	AAAGAGACCCAGGAAAAGTGGCAAGTGGC
ACTGCATGTACAAATATATCTTTTGAGAT	GAAACATTCCACTTGGCATAAAGCCTC
TGTTATGGAATGAATAAGGCAATTTTTGT	TATAACTGGAATACTGACCGTCAGCAA
ACAAAGGGACCCGGCGCCGCCC	CGCGGAGAAACGGCTCCAGGCAGTTT
GCACAGGGCCCTACGCGGCCGCCTCA	CGTTCACGTGACGTCCCCAGCGTT
TATCCCGTGCCCCTCCTCTCACCCTT	TGGGTGGCCTGTGTGTGTCTGTGTCT
CCATACCTTTCCCTCCCACCCC	CTTCCCTGGAGAGAGTGGAGCTTACAT
GGTTTTATCCGGCTTTTATTCCCTTTG	TTCCTCCCCTTCCCTCCATTCCCTTT
CCCCTTGTCTCCTATTCCCTCTGCA	GCTGATGTTGTGTGGAGCTGCCTT
TCCCTCACCACTCCTTTCTCTTTCAT	AGCTGGAGTGGCTTAGGAAGTTGTGTA
TGTTCACAAACCTGCCTCTCCTTTC	CTCTGAAGACGATGGGCAGAGGAGTGA
CCCTCTTTGGAAACACTTTACTATACT	CAATCAGAGGAGGGACTTAGCTTCAAC
AGCACTTGACCATTTAAATAATGAAGAC	TATAAGTAAGGAAATACTCCCCCAGCC
ACTCATAAAAGGAAAAATGAAACAGAAGT	TATTATATGGACAGTCTAAAACATGAGTGA
TCCAGCTTTCACGTAAATTATAAGAAATT	ACTTTATCCCAAATAGTACCACAAGGC
GGCTCTGAGGGTTAGGTATACTAGTAA	CATTCTCACGTATCAGAACAAGGCAAC
AACAGAAAACCTGAATAATGCATATGTT	CACAAGTAAGCATTTCCAGTTAGGCAG
TGACTTAACGGCATATTTAAGATGAAAAA	CTAGTGGCAACATGCTAAATGACACAG
TAGTCGGTCCATGGCTTCCAACTAGTA	CAAGAGAACAACCATGAGCTCAAACTG
GACTGATACAAATTTCAAATGCATAAAAGA	ACAAGATGTAAACAATGTTGTAAAAACCA
GTGTGGGATTGTTAAAATATTCTTGCC	CTAGACAGTTTCCCTCTATCAAGATTG
CAAAGCAGGTATGAATAAATGTATTCAATT	GAGTCTGCTATTCCTTATTATCAAGGT
AAAATTGCAGGGCATGGAAATTTAGCT	ACTGCATCCCCTATATTGTAATGTGCT
GACCCCAGAACTTAAAAGTATAATAAACA	TGCAAATAAAATGTAGACAAGTACAGTCC
TTAGGAAAAATATGCAAAAGGAGTATTCT	TAGTTGCACCATCCTGAAAAATTATATCC
CTGCAAAGTGAATTATCTCCATAATTTACA	AACCCCAGATGTCAAGCTACAAAATAC
ACACACAAATAATATGAAAACGTTTGTTT	TATTTATGACATGCATCCTCCTGAACC
GCTCATTACTGTGCCCATCTCAAAA	TGGTGAGATATGCCACATTCATGATTT
GCAAGAACTAAACTGTCAATGTTAAAGA	GCATTCTTCAGTAAAGGATCTATTGCT
CGGCTTAATCGATACCTTATTTACATTTTC	AGATCATTTGTTATTTAGAAAGTGGGGA
TTCTAGACTGTATCACCTATACATGTAACC	AGAACAAGGTCTTGTATTAAGACTCTCC
CCACATTACCCATATTTCATATGTAGTTCT	GAAGGTGATTTAAGTCACATCCATCGG
TTTAAGTTCCTAGTATAATACACAGCATGC	AACATCACACAATTTTAGTAATGTCCAAG
TGGCTTTGCATCTTTGACGTTTGAGG	TTGTCAGCTCTTGGGCAAAGCAGAAGTG
CGAGGTATGATAGGGGCTCCCAAAGTT	TTAATTAGCATGTAAATTCTACACTCAAGT
GTGAACAATACAGAGTTCTCTTCAAATAA	AATAAGAATATGCTTACTTCAAAACACCA
ATCAATAATGCATTTCCACTCCAAAAA	TCATATTAGCAGCAAATCCATGTAACT
GCATATACAGGTATAGGTGTAATACTCTAA	AGTGAAATGTGCAAAGTTGTCTAAGCT
ATTTTATGTATGCTAAATTGGATGGCAA	AATAGGTACCTAAGCTTACCACTGAGC
AGTGTGAACATATGGCACCTTTGGAC	AAACAAGCTGATAAGTCGATGATGGGG
GCAGGACTCCTTCAGTTCTTCACTAGT	CACGTCCATTACAATTAGAAGAGTTCA
ATAAGCTAACACAAAGCTAAACTTAAACTG	CATTTACTACCTGTATTTTCAAGGAGC
TGATATACACACGAACAACTATGATACTC	TCGAGGGGAACAAAGCTCAATAAAGTC
ATCAAATGTAAACAAAAAGTGTTCTGAAG	GCTTTCCTAGGTTCAGTGAAAATTGCA
CCAGCAAAGAATACGGCAGAATT	AATATACTGTTGCAGTGAGCAACCTGA
AGTGGGGTTCAATGGCACTATGACAT	GAAACTGCTTTATTCAACATTAAGACGA
CCAATACAACATACTTTAAACATTCCCCC	CAAACTTTCACAGAGATGTAACACATG
CAGTGAGGCATAAACTGTTGGGACAT	GGTAAGTCGATCCAGTACATGGGCAA
TGCTCGTGTAGTAGTTTAAACTCTTAA	CTATTTGGGGTTGTAAAAACGACCAGG
ACCACCTTCAAATTTTCAAGAATAAAATTT	GGCATTGCTACAGACTTGAACGTTATG
AACAGAAAAAGGCAATTTATTAACAGGA	ATTGCTTCTAGAACGTACCAGTTATTA
CAAGTAGCATCTGTATCAGGCAAAGTC	AAAACAGTCAAGAAGAAAACGGCATTT
TTTCCTTGCCTCTTTCCTAGCACTGCCC	GCAGTGATGCCTCAAAGACAATGG
TGAAATATTCTCCATCCAGTGGTTTCTTC	CTCTGTGCGCCGGTCTCTCCCAGGACA
CTGGAGCTTAGGCTCCAGAAAGG	AAGAGAATCTCCGCAAGAAAGGGGAGC
GGCTGCAGGCGCAGCGGCATCCAGGACAT	GTCCCGCATGGCGCTGTACTCCT
TACCAGGGAGAGGCTGGCTGTGTGAAC	GTGTGTGTTTGCCATCAACAACACCAA
GGAATCCTGCAGGAGGACAGGGCTCA	CTGGCTGTGTCCTGGGCTCGCC
TGTAGGAGGACCCCGGGCCGCAGGCCC	ATAGGGCTGGCTGCAGCCCCTGGTC
TACCTTTCATTGCTTACAGATAATATTGG	AAGTTACAACCTCTCTGGTATTAAAATTTT
CTACCCAGTTCCAAAATGCCTATAAATAA	GGCTATTTATAACTGCTAACTGCGCAAC
AAAAATCACTGTAAAGACATGTGGTTC	TTTTGTTATAAAGGTGCTTTTACATCTTCT
GCTTATACGAAAGCAAGAAACAAGGCA	TAAAATCCAGCTGCCAGAAGAAGCAC
CAAGTAAGCCATTCTCAAGAGGCAGT	TCGGTATTTCTCACTATTATGTATTGATGT
GCACATAGTGAAATGTAGAAGGTGAATTC	TTTTGTTTATAAAGGATAACAGCATCAGTA
TTTTCTTTTTCTATAGATCTGCCTGGCTC	AATAGGAAAATTTCTCCATGGTGATTCT
TTTTTGGCTTTATCATTTGAAGCATTTGC	AGGTATGCCCTTAGCAACAGAAACAC
GAAAGCAACTTAGTCTAGAGCTAAACA	AATGCGCCTCAGCAGTGCCATCACTCT
AGTTTGAAACTTGGCTGTAGCTGATTG	TGATCTGCTAAATATATGTACTTCACTTTG
TCAGTCATCATTTGCCTTAATTTAGCAAG	AACATGTTTTCTAAAGAAGTAGAATTGGC
CCTGCACATTCTGTACATAATCATTACTTG	GAATCAAACAGAGTAACCAGAACTCGAG
CATTCTGTTTCAAGGTTTGTATCATTCA	TTATTACGAATTGTGATCACATCCTCTG
ACAGATATCATTAAAGAAACGTGTATTTGT	GGATCCAGGAGTTTTTGTAGATAGGTAGC
CTAGTATTTTTGAGGCCTCAGGTAAAA	TAAAAGCTGAGGTGATGGCAGATACTG
CCAATAACCTGTAAAGAAGCAGGATTTT	AAGCCACCTGTTGCACTGGTTTTGAT
TTTTTGTGCTAAAACTTTGAGTCCCATG	GGCAGCTCATCTTCCCTACCTCTT
CAGGTGAAGTAAAATGGAGAAAGGAAC	CATCAAGGGAATTGTTGAAGGACAGCA
AAGTATCTACTAAAGAAAGCTGTTGAATTT	ACTGATCCGAAGATCCAGGCGCTGCTT
GAATTGTTATCTGTTTGGGTGAGAAGTAG	GATTCAGACACTGAAACTTTACGTAAAT
CCAGTCTACTTTTAGGAGGCCCTTAAA	GGCCAGTGTTGTGTTTCCCAAAGTCTT
CAAAACTAATCTTAACCCTCATTAAACCTA	CTGCTAAGTATTCATAAAGAATTCGTTGA
GAGAGAGGAGAGAAACAGTTAACCCAG	AAACGTGGCATGTCTCGGAGGCT
GTAATTTTTGCTTCTCTTACATGCCAGTT	CAACTTCACTGCAGTCATTCAAAAGGT
TGCACTCCATAGGTGAGATCAAATGAA	AGGCACAGAATTTGACACACTTGCAG
AAGGATTTGCTATGTGCCAGGCACTT	GTTGAAGGATTTTTGTCAGAACTTCCATA
TTTTCTAAATTCAAAATGAAACATGGAACT	GGGACAGGTCATTCTCTCCTGGCTCCTAT
CCTGTTACCAATAACACAGTCCATGC	TAACTGGAACGGAAGGCAATGACAGCAG
TGGTTTATTGTGCTATTTTGTACTTAATGC	CAGTGGACAGAACTAGCTCAAAGGTATG
GGATTATATTGGAATGCAAATCTGCAATTA	GGAATATCTCTCATGCATGCCTAAAAA
CAAAGGTTTTTATAAGTTCTGTGGATCTT	CAAGTTGTAAAGCATATCTTTCATTTTTCT
ACCTGCAGCCTGCCCACTCTCCCCTA	CAGTACCAAAGAACTGCTGAAGATCTC
ATGCCAGCATGGCACCCCTTGGCTT	GTATCTGTCTGCCTGTCCATGTACTTC
TAACCCCCTGAGCATTTTAAAAATTAC	CCCAAATTACCCATAATTTTCTCAATTGTC
ATTTCCTTGGAAAAGCAGTCTAAAAGG	GCAGCAGATATTGATCATAAACTTGAAGA
CACATCTCATGGGGTTATAGGGAGGT	ATTTCCTTCCACTCGGATAAGATGCTG
ATGACGGAGGTTGTGAGGCGCTGCCCC	ACACTTTTCGACATAGTGTGGTGGTG
GCTATCTGAGCAGCGCTCATGGT	CAGAGTTGAAAGTCAGGGCACAAGT
CAATCTTGAAGTGCTTTTAAAAAGCTAAC	CAAATACTCATACAATACAACACCCAAGTG
GATTTCTCGAACTGCTGTTGTCATGAAG	ATTCTTGGAGCACTGAAGGCCATTGT
TTTGATGCAAAAGTTTACCTCTTGACAAG	AAAAGACATATTCATTTGGTTTATGACTGC
CCATTTTTAGCCTTGAAACATGGCAAAC	CACTTTTCCAAAAGCACCTGATCCTAG
GAATATGAATATGATCTCAAATGGGAGTT	AAAACAGGAGTCTCAATCCAGGTTGCCGT
GCTGCAGAAACATTTGGCACATTCCA	GTTCTGCAGATAGAGGAAAGAATAATGA
GAATTCTGTTTCATCGCTGAGTGACAC	GCCTATTCCTAACTGACTCATCATTTCAT
GTTTCTTTCTTAGTGTTTGATAGTAGCAT	CACTGATGATACAAAAGCAAACAGAATCC
GGACAAGTTTGTATTCTGAAAATGCAGGA	TCCTCTTCAAAGCATCCCAGTCAATC
ATAAAACAGAGTTTGCATTTAATGTTTTCA	ATGTGGTCTGAGGAGTTTGATTTAGATC
GCTGATTTCTTCATAAAAGAGGAGTCAGT	GCCACAATTATTTCTTAAAGTAGGGGAAC
AAGAAACCTTTTCTCACACACTGACCC	CCCTTTTATGGCTTCACTCATGTTTAGAG
CTCGCTGCAGAAATCCTAACTTCCAAT	ATTCCCTTGGCACATCTTGTGAGACGA
AAAGAATTTAGACAGGTGAGCTGTCATC	GAGAGTTTTATGTTCTTCCATTATAAGAGG
TATGCCCAGCCAGTGAGCTTATTTCACA	GACCTATTGACTCTTTCATGAATACAGTT
CCACTAATGCTCATGGCAAAGTGAC	TTAACCATCATAACTGCAAAGAGACACAC
CTGCTATGCAAAAGGTAGGTACCTTTG	AAGAGAGCCATCCAGACTGGCGAAGAGC
ACTGAAAAGGGAGTTCCAATTCTCACG	CAACTGGTTACAGTTCTTCAGGGTTTG
TTTTACAGACAGTGATGTGTGTTCTGA	GAAACAATTAAACATCTAGATCGGCATTC
CAAGGCATAATGATATATAGGAAGCAAAGA	GGATCTCGAATCAGGCGCTTAAATTTC
TCCACATAATGACAAATAAGTTTAGCACAG	AGTAAGATCTCCATTGAAAATTTTAAAGCA
AGCAAGAAATTGTGTAAATACTTCATTTAC	GCAAAGTTTTAAGGCAATTTACTAGGGCC
ATTCTTAATGTAATGGGAAAAGACTTTCC	AAAATAGCTAACACTTGTTGAGTATATACG
TCTATAACATAACATTTAGAGTTGGGAGT	AACCCATTACTAGGTAAATTGCATTTTTC
CGAGGTCATATGTTACTAGGGCTTTGC	CAAACTATCTGGCTCCCCTATACTTCTG
CGAACATATGAACACGAAGCAATGTGG	AAGACTAGAACTTATCTGTTTTTCAGAGG
CAAAGAACACACATTGCTGTGGTAAAA	TCAGGTTTATCCACAAATCATTTACTTTAA
AACTGATGTGTTCTGTTAAGCTTATAAAG	GTAATTGGAGCATTTTGGTAGGTACAGTC
CTTAAACAAAAAGCAATGTAGTTCTTCAAG	GTAAGAAACTGTCCTTGAGCATCCCTT
GATGTTTGTTCCCCTCCCCCATCAACTA	CGGAAGATGAAACTGAGCTTCACCCTA
GGACAAAAACACAAAGGTTTCAGTGAG	GATTCATGGTCCAGTCAAAGAGTGGA
GGTCCTGTTGTCAGTTTTTCAGATTTTC	CATACAGCAGGCCATAGACCCCAAAAA
GTGGTGATTAAATCAAGTATTAAAACCAAC	GCAAATTCACTTGTCCACCAACACTGA
AAAATTTTTCATTTTGGCTTTTCAGCC	TGAACTGTACCGAATGTCTACGTATTCC
TCAGTAGGACTGTCTCCTCTTTTCCA	GTTGGCGCTTTTCATCAAATTTGATAAGA
ACTGGTGTGAATGACAAGGTCAAATGC	ACTTCCGGGTACAGAAAACAGTGGAT
TGGCCATGTCTGAAAAGTAAGTAATCT	AGGAAAAGTAGGCTGAGAGGTAGCTTC
CAAGATTTTTCTGCCTTGATGAGAAGTTCC	AAGGATAATGCTATGTCAGAACACCTG
CAAGCTGCTCAGGATTAACTAGAACACT	CACAGGCAAAGCAAGCCACTCT
GAGCATGCAGACACATGCAGCC	GCTTTTGCTGTGATGGTGGACTCA
ACTAAGTAATCCATCCTAAACTTATTCACA	TTTGACATCATCACTGTTACCTAAAATTA
ATTAAAGACTTCTGTTGCCTTGAAATGAG	ACTGCCTTTTATTAAAAATTCTTTCCTCT
CTGTACCCTTGATTGTACTCCTACAAA	GCTTCTTCAGTGAAAAACTAAGAAAATAAA
TGTGCTCCTTCTTTAAGAAAGTGTCCT	TTAGAAACTAAGAGAATGATAGGCTTTTG
CTCTTTTCAGCTAACCTATGACTATCAGT	AGGGTTGGGGCTGCCGGCTGACCC
TTCCAGGCTCCACAGTGGCAGGGGAT	GAGGAGCTGCTTTGTCACTCAGTCA
TGACTCTGTCCCACTGCCCAGGTACAT	TAAATGTGGATTCCTAGGCTGGGCACCTCA
CCTCTTTGTCAAATGTCACGACTTCG	CGCCGGTCAACGTAGCATCAATCACAT
TACATGCAACAAAAGCCCCCACTGCCTG	AGGGATTTAGTGGTCCCTGAGAGTGG
AAGGGACAAGAGTATCAGAGAGTGGCA	GCCAGCTCATACCTGCTCTTCGTAGATTT
AATGGAAGAACAACGTGTACCTGGCTCG	TCAACCAAGGAGCAAGGGCAGGATTG
AGCCCCAGGCCCTGGATACGGGA	TGACAAGACAGCTCTCCCTCAGACCAA
TTGCTTTGGGACAGGACCTCAGCCAC	AAACTCAGACCCAGAGAAGTTAAGTGGCC
CATGGGCACCAGCTCTGGAGGTGCAA	CTCTGTGAAGAGGCTCTCACAGC
GCTGGCAACAGGGCCAAAGTGAGGAGAAA	AGGACACACACCTGATAGGAGCAGGAAAA
AGCCCTGGGGCCTTGAGATGTTAA	CTTCCACTGTGAATGGCAGAATAGTTAC
CTCCTAAACCCAGCCTCTGTCACATA	GCCTGGCCACACACCTCACACACAATA
GAAGTCTAAGAGTGATTCCCCATTTTCTCC	GGGGGTGGCGCCCATAGCGGAATAAATA
GTGCATGCCGTGCTTCGCATAG	ACTGGCTGTGCCCGATCAGAGCCTA
TCCCAGCCCCTTCCTTACTGATTCA	TCACTGACCTCCAGTCCCTAACCCCAAT
AAACTCCTGGCCTAAAGTGATTCACTC	CAATCAGGGCCAGTGTCTGGGCTCTT
AGGCACTGAGCCAAAGAAGGGG	CTATACCCTGAAGAGCCAACTAGACATC
TGCCACACTCACCAGGACCCTCAGCTT	GCTCTACTACCAGCTGGGTGGGGACAA
AGCATCCCAGGTATGTGCTACTCTG	AAGTGAGGTGTCAGTCATGCTCACAGTC
TCTCCCCCAGCTTCGGACAACC	CAATGCTGTCAGGAGAATCGCTATCCT
AACAAGGGTGGGGTACAGGTTGCCTCA	ATCTTGGGGGAGGAGGCCCCTCGTTTCCC
TTGAAATCTCCATTGGCCAAAGGAAAT	CCAGGGCTGATGGTACCTTCTCCCAATATT
TGCAGCAGAAGATGGTGAATGGC	CTGTGTGTTTACATAACAGGGCACC
AGTCAATGGGCAGAGCCAGCTGAGGGG	ATCTTGCACACAACACCCCACCCCC
AGCAGCTGGGAATAGTAGTCAGGG	CATCGCTGTCTTGCACAGCTGG
AGAAGGCAAGCGACAGGTTGGTGAGC	ATCTTGCCCCTTGTAGGAGCTGTCCCT
GCAAGGCCTCGCTGGCCCTGAC	CCCCCGCTGGCTCTAGGACCCACTCTA
AATGTGCAACTCAGCACTGGGCGGGGGTC	AAGAGATGAGGGCTCTGAGGAGGAGGGT
CCCAGCCAGCTTGCTGTCAATGT	GACTGGGCTCCCAGGGCACATGGCTCTT
TCTGGGACCTTGGGATCCCCCAGAC	AATAGGGGCACCAGGAACCAGCAACCACC
CAGATGCCCAGGTACCAGGCTGCTCT	CAGTGGGAAGCTGGGAGCTGGGGGAA
ACCTGTCCTCCAGTCTGGGCAG	TACCAGGAGCCTGGGACCCAGACCTCT
GCTGTGCTCGAAGCTGACCCACCGTA	CAGGTGGGGCACAGATGAGGCCTCAGAA
TGCTTGTCCAACCCCAGCCCCAG	ATCAGCCTGGGTCCATGACCCAGAAC
GTTGTCCTGGAAGCCTCAGAGGT	TGAAGAAACGGCTGGGTCTACGGTGTTTT
CCTTTTAAACCAGAGTCGAACTTTACTGTC	ATCAGGGAGGGCCGTTAGCAATAGGAA
ACCAAGGCCTCCTGGTCCAGCAG	TTATGGGACACAGGCTGGTCACAGCCCAGC
AACAGCAACATTCTGGTGGGGCTGGAT	TAGGACAGGTGGCAATCCAGCAGCAAC
AGCAGAAGGAGCACACTAATCTCATGG	AAGCCGGAGGTCTTCGCCTGACCCCT
TCCTACAGATGCAGCTGAAGGTG	TTCAGCCTAGCACCCAGAAGGCAGGGA
CTTGGCACACAGAGCCTTCCGGGACTT	TCCCCTGCACCTTCCTCCCACG
TTATGCCACTGGGCCACCCTTCTTAGGGC	TTGGGATTACCCTTTTGCAGGTCCTGA
CAGCACTCCGCTCCTGCAATGAGAGA	GCTGTCTGGAGTCCACCAAAGCACAGAA
ATTGGGGTGGCACCTGGTATGAACAG	GGGGACCTAGCAGTGATCTGCA
GGCCAACCCCATTCCAGCCCTGAGTCTTA	CAGTGAATATCTGCGATTCCCTTCAAC
AGAAGCCCATGGGCACCATGCCACCT	GGGACACAAAGAACTTTGGCTAAATATCAT
TTTGCCAGCTGCTGCTGCATTGCCAATT	GTGGCTGGGTGGGCATCAGTGG
TGGGAGAAGAGCCCTCATGTGGCAAA	CTCTCCATCTTGTCTAGCTCATCCCCA
AGAAGGCCTCCTTTGGGGCCACGGGAGG	TCATTGAGGACCTGTTGGAGCATGA
GGGAGGATCCTCCTGGGCCACTCAGT	GCTCTACCTTGGGGGTAGCAATGGTGAATT
TGAACGGGAGGCCCTGCTGCGGGG	GGCTAAAGCCAGGACAGAGCAT
ATCAGCAGCAGGGGGAGGGCGCTCCTCA	CCAAGTGGGGGTCATTGGTCTCCAGGTTTT
AAGCTGGGAAGTTGCCCTGTGAGGATC	TGCTGGCATATACTGATCCTGAGCTG
AAGCTCTTCATCATCCTCTAGGGCCTT	TCAATTCAGGGGCCGGTGGGGCTGA
AAAGGACTGGGACCTGGGGGCACTCCGT	AAGGGTCCTACCCTGCCAACTGGTT
GGTCCTCACTTACAGGGTAAAAACG	AAGTTCAGGTCCAGGAGTTGATGGAA
TTCCAGGCAACTGGTAGGAGGCTCCCA	GGAATTTCCACCCGTCTGCCAG
TTGCTGCTGTAAGGGCAGGGAC	AGTGATACTGGAAAAGGATTAGTGATACAG
TAGCGATGACCGACTCTCCCGGCCACC	CTCACTGCATTAATTCTATCCTTCCTCAC
TGGAGCCTCACCGGCTGTTCACATCCATA	ACTATCCCTTGCCACTCTACCTACCT
AGATCCAGCGCAACACCCTGCGGCA	CCTTCATCTACCTTGTCTCTTCTAGGACA
CCCAGCTGCCTGGAGGCCCCACTGCT	CTCCAGGGTGTCAACTTACCTGC
TCACAGCGATCAGGCATCACCTCTCCT	GGCAGCCCTATGATTGGAGTAGAATG
TCAGCTGTCGCCAAAGAGCTACCCATT	CTGCCCGATGGGTGGAAGTTCCCTGT
ATGCGTTTCACTTTCCCTCAGGCAGT	GGAGAGCTATGGGCTGTCCCCA
GGGTGGCGGGAGACCAGGCTGA	AGCCCCCAGCGAAGTGTGGGCTAGAGA
AAGCTTTTTGCCCATCACCCGTTACC	CCAGCAGGTGAGCTCCATGCCA
TGAGGGCGTGAGGGTGGGCGAGAATAA	GGAGGTTGGGGCCGAGGAGTCAAT
TGACCCCTCGGGCATCTCAGGTAGAG	TCGCTCACTGCCCTCCGACCCT
CCTGGGCAGGGGGTGGCTCCTG	CTTCTTCACCTCTAGGGCCTTCC
ACCCCCAGACACCAGCCCTCCAC	TATGGGCCCCCAAACCTGGGCTTTGTT
CACAGCCAAGTTATCCAGCGAGG	GCCGTGGGGAAGCGGGGCTCCAGGGGATA
GCTTGAGGAAGAGCTCACCAGG	ACGGGCTATGTCGCCCACCTTGGTCT
AAGGTGAGTGGGGCTGGGCTGGGGTGT	ATTCCCCCGCAGCCAGGGGCACTGGGCA
GGCAGGCCCCATGGCCCTCCACCCTCAA	TTTCACACTCCCTACCCAGAAGCAGAT
AAAGGTTCCAGCAGCTGACAAAGCCCCC	AGACCAAGCACTAGGCCCTAAGGCTG
TCCCTCTCAGTTCCCACGCTAATCCAT	CCCTCATCCCACAGGTACCTGGGTAGT
ACAACCCCCACCACGGAGGGTGA	TGGAGGAGTCGCCTGCCAAGTCT
CCTCATCCTTCTCCCAGCGCTGAAGA	ATGCCAAGTCCCACCCCAGACAAACT
TCTCTGCGTAACCTTTGTGGGCAGTCC	TGTGACTCTCTGCCCCTGCGCCCCAGGG
GCAGGAGTCCGAGGGAGGCAAAGCAT	GCAACTGGCCCATCCTGGAGGCAA
AGCAGCTCTTCAAGGATGTTCTGG	TAGGTGGACTCCCTTTGGGCAATCTG
CTGCCTTCTAGGCCAGGGGTTCCACAA	ACTCCCCACCAGAGAAGCTGTACAGAT
AGTGACCCTGAGAAGCCAGGCA	TCATTTGTAGACCTGTGGTGTCACCT
GCCTCACCTTCTGTGGAAATCCTGTCTAA	CAGCCTCCAACACTGACAATGCT
TCTTGCTCATAGGAGATGATGGTCCA	AGTGGCCATGACCCATCCTGGCCTTG
CTGGTGTATCGGCTTTGCCCTC	ATCAAATAACTTGCCAGCTCCTAAGCC
TTTTTGCAGTTGGGGTGGGCCGGCCAAGCT	AAGGGTGGGGTCAAGGGTCCTGGCCT
GAGTTCCTTCCTTTCTGAGCCTCCAT	CTTGGAGCCTGAGACCCACCTGCAAGTAA
TTCCGTTCTGTCCACAGTGATACCTGC	GCATGAAGAAAACTGTTTCTCCTTGACTG
TTCTCATCCCCTTCAGCTAAGCTCT	CTGGGTCTCTCTAGCATTGCCCCA
ATAGGCATTGGTGGTTTCATGGTGCGAC	TGGTAGACCCAGCTGGTGTTGTGG
ACCTCCGCCTGTGCAGCAGGCCCCTTTTT	TTTTTGCTTTCCTCGGTCTCCTCTTTG
TATTCAGCTCTCTCAGTGGCAGGATGACAA	TGAGGTCCTGGGATGGGGTTGTGGG
CTGCGTATGGTGACAGAAGAGATGGA	CCTAAGATTCCCCAAGCTAACCTTCAC
TAACCTGACCATGTCACCACTGCA	TCTGGGAGTGGGATGTTGGGTGGGGG
AAGCCGTCCTCGCCGTTGGCGCCGCTT	ACAAAGGCAGTGACAAAAGTCCAGCT
TATTGTGCGATGCTGGGACAGCTATCAGC	GACTTGGAGATCCTTTATTCCAGTTATTA
AACGGGCTGGGGAGCTGCGCCG	TCTGGAGAGCCCAGGAGGGGCTCTGA
AGACAGCAGGGCAGGGCTCACCATGT	AGTTGGGGGTCTCTACGGATGTTAG
AGTGGGTGGTGTGGGGGCCACC	GGAGCATCAATCCCATCCAGAGG
CTGAGAAAGTTTCAGAACCTGAATGCC	CTGGCAGTTTGGCTAGTGAACTTAAAG
AGGTCCCCCATTGGGGAAGGGAGA	GGGAACCAGGGAATGCTGAAGGAGT
ATCCTGGAGACACCCATCAGCCCTCC	TCCTGCCCTACCACTGTCCGTTC
GACAGGCTCAGGGTCAGTGCAGTTA	AAAAAGAAGGGCTCTTAGATTAGATGTGC
TGAGGCGACAAGGATGGCTCCCCAGAT	GGACAGGGGTGGCTTCTCAAGCTCA
TCAGCCTGAGGAATTGCACCTGT	AGGCCAATGCCCTGCACCTGAGG
TGAGGACTCCCCCACATCCCCACCACC	TATCTCCGCAGGCTGAGGAGCCAC
CGGCAGGGACATGAGCGAGTCCT	GGGGACATAGGTGATTCTTCAGGTG
TCACCCATGTCTCCACCACCGGAGGC	TGCCTGTGGTGTCACGCCTGTCT
CCGCTGGAGGAATCGCCCCTCT	TTTGTCCCCGCCACCTGAGGAATTGCCCA
AGAAAAAGGTGATGATTCAGGTGGGG	CAGGTGGGGGCAGCAGTGGCATCT
TATGGCAAGAGACAGTTTGTGCATTGCC	AATCACCCACGTCCCCACCACCTGAGGC
ACAACACGATGCTCCTATCTAGCTCA	GCTGCCCTTGGCATGCAACGTACAGA
GGCAGTGCCATCCACAGCATTC	TATGCAACCCAAGGAACCAGGGCCCCTGCA
GGCACTGTGGCTCTCACCAGCTAACAAAT	GTATGCTGCTCAGCAACGGAGCGGATA
AATGCCTGTTTTGCCCACTCCCTTCC	TGACTGAGATTGGGCTGGCAGGTTGG
TTCAGTTCTGCTGAGCCCGCCCCACA	GAGCAGGCAGTTCCTCCATGGGTGGTTTTA
GAAGGCCTGTTAACATGAAAACAACAAAA	GATTCTGCCCTATTGTCCCTAACTGT
CTGCAGGTGCACATGGAACATTACA	CAGTGTCCAGGCAGGCCCCGTGATAGT
ATTCTGTGCCCATGGAGTGCCTGTTTTGT	TCTGACTGCCCGCAAACGTGCTGGCTG
CCTATTTTAGTGGGGCAGACCAACA	GCTGGCAGTCGCGCAGGGGAAGTGGTAAA
TATACTGGGGCAGAGCTAGTGCCTGAACTG	CTGCTATGCCCAGAGCACAGTG
AAAAGAGCCTCAGTGTCAGCCAG	CTCCTGCCCCCATACGCCTGCCGACCAT
AGTGAGGAGAATGGGGCAGGAAATGGG	ATCTTCTCAGGGATCTCACAGGTGGGGC
AAGAGAAAGGAAAGAATTAACAAAAAGAGG	GGACACCACTGGACACCGGGGCCAATCAAA
AGATCATGGGGTTGCTGGGGGCCTGGCG	AGTGCTGCCCAGTGAGGACCTATCA
GAGCACAACGCCGCACCGGACC	CCTGGGACTCCCAGAACTAAGGACAGA
GTCTGGTGAGTGGACTTTGTGTTAAATAG	CTTGTTTGAGGGCACATGAGGATTTG
AGCTGCAGGTCCATCAGCTGAATAAA	GGACCAGAAATGTAAGGTTGCCAATG
GCTTCTTGGGAAGACTTAGTAGGCATATAG	GGCACAAGGACATGAGCTAAGTCTATG
AACCACTGTTGTGACATTTTTATATAAGC	ATGTAAAGATTGAGCCCTGTGGACAC
TTAAACCTAACCCCAAAAGCCAGGCCACCC	ATAGTTGGAATGTGGAGCCCATCTCACAG
TTTCAGCTATGTAATAACCTTGGAAAATTC	GGTCAGGGCTGTCCTTTCTGCCGATGT
GAAGAGAGTATCATCAGCTCGTTCATCA	AGTAACAGATGCATCTGAAAATACTTAAA
CTCCCTCCCCAAATTATGATGATGATG	TTGAGCATTTACTATATGACAGATATTGTG
CTTTCATAATCAAGCACATATAAACTGTG	ATCTCTGTTTTAATGTAGTTTGCTTCTAC
ACACGAATACTGTTTGATTTGTTTTTAAA	GCACAGGATGGCTTTGGATAGAAGAAAT
CTGACCTGAAATGAAGAGAATACTCATTGC	TTTCATTTCCTCATCAGGAGACTGGAA
GGCGACATAAATCTAAATTACTAAAGTACA	CCAGATTTGTTAATGTAAACTGGATATGTT
GATACCCAATAGCCTTCAAGAAAGCAG	TCAGCCAAGGCAGCAATGGCCAAA
GCTTTTACCTAATTTTGTTTAATGTGAACA	GCAGCAACTCCTTATGGTATCGAATCTTT
TGCCTTCTCTTTTGTCTATATCTGATAAT	GTACAGAAAAAGAGTAGATATGCGGTT
TGGGCATTGATGGCAAATCATTAATGT	AACCTCTTACACACTGATACTGGTAGT
AGGCCCCTTGCAAAGCAGAAGT	CATCTCCCTCCTTGGGCCGCGCATCAT
TATTCCCGATGACCCTGTCTTCCCGTGC	AATGTGGTGGCCATGGGCGTTAGTGACA
AAAGCCATCAGCTGGGGCTGTCTGCATA	GAGAGGTCATTGCAGGGACTGC
TCGTGAGCCTGCAGAGCAGCTGG	ATCGTCAACCCTGCTCGCAAGGGCCTC
TGAAGGTGGTGTGACACGCAGGA	GCGCCTGCTCCTCGGATGCAGG
TACACGGACATGTGGGTGGAACCTGAGG	TTGCAGAGCGGCTGGTGTACGAGGTGC
GTGGAGGTGGTGCGTAGGCAGCT	GGTTCTAGCCAACCAACAGAGAGCA
ACACTGCCAAGGCCGTGGAGGTGCAGA	ACAGAGGGGCCCAGTGGGAACAGCCGGG
GGCCAGAAGGCTGGAAGCCCCC	CAGACTCTGAGTAGTGAGGGTGGCACA
AGGAGCCTAGAGCACTAGGAGGC	CTGTCCTGACAACCCCAACCCT
CCCGACCTGCACTCCAACTTCCA	AGGCCTTGTTTGCCGAGGCTTACACTT
GGCAGAGCAGCTAGTCATTCAGCAGA	CACAGGGTTGGACTACAAAACAGGA
TAGGTGTAATTCCAGCTTCTCCTGGAGG	ACACAGGGCCCGCTACTTCTGGGGTAA
GCCACACACTGGGCTAGCCTGCA	ATGTGATTGAGGAGCTGAATGGTTAATG
TCACTGCTTAGGACCCTCCAAAGG	CAGCTGTTAAAATATTATCCCAAAGGGGAA
AGAGAGACAGCACCCGGATGGGCTT	AGGGAGCTCGAGACCGCGCCCCA
AGGCAGCCATTAAGGAAGACCCC	TGTGCGCAGGGTGTGTGGGTCTAGG
ACCATCTGCTGTGGGGGCCGTGAG	TTGGCCTCCCCGGACCAGGGCTGAG
CAGTTGTTGTTTCCGCACATGAGCA	CTGAAGACATGACCCCGCCACCACCTTA
GACTCACATAGCTTTGCATCCTGCCAT	CATTATTGTGATGATTCTGACCTACAAAT
CCATTTATCTCCTCAACAACCTTCCAC	AATCAGCAAAGGAGTGAACAGGGTGTGGG
CCCCACAGAAACCCATGTATGAAGTAC	CTCCAGTGGCTTCCTTTGTTTTGTTC
CATCGTAGGAAAATGTCTCTGGACAAC	TGCGGCCATGACTGTCGCTGTAAAGAT
GATTACCAAGGTAACTCAGGACTTTGA	TCAACAACCTTCCCGAAAGCTCCAGC
ACAGAACGGGAAGCCCTCATGTCTGAA	TTTTTACCCAGACTGTTGTTCTCTCTTGC
GTTTTTGTGAGATGGTACTCAAGTTATCAC	CGTCTGGTCCTATGGGATTTTTCTTTG
ATAGGGGCTGCTTCCTGAGACACAGTT	AATGCTTTCAGGTGCCATCCACTTCAC
GCTTCCTTGTGATTAACACTGCTTTGC	GAGACAGAAACCCAGATGTTGAGGGTT
AGAAAGGGTTAGGAACTTGTCAGTATTC	GAGAGCTGTGGGTCTAATGAAGCCA
GTCGACTCTGAGATTCTGTAGAACAGGA	CTCCACTGTAGCTGGATGGCGA
GTATCTCTTGATGAAACATCTTCGAACGC	GTGAAGAATAGAAGTCTGGTCTCCAGC
GCGGAAAGGAGCAGTCAGGGCCCTTCA	CCAACATGCTGCGGTCCATGGGGATCA
TTGGTACTGATCTTCTGTCCTGCCACC	CGCGAGATTTATGAGGAACTGGGTC
TGCGAGTCCGGAGGCTTTCAGGACT	CTGCTCTAAGATAGGGGCTTCATCTTC
GGAGACTGACCTCTTCTTCCACCT	GTGAGAACCGCATGAATCCCCTC
ATACCACAGACCATTTCTCCTCATTTC	AAAGGAAGGCCAAGAAAAACTAATTTT
GCTTACTTAACATTTCAAATGATGAACTT	GGGCTCCAGTTCATGTTCATTAAAACTT
GTTGGATTCTTACTTTTGTTGCACCATG	ATGTAGGGGAGGAAGAAAATGAAGCAC
ACTCTAAAATACTAATGCTGGTGGGGG	GCAAAATCCACATTTAGGCCTGGTG
TTCTCTGTAGCATTTCTTGAGACTTAAAG	AATAACACATGAATGTTCCTGAATACTAAA
GACTTTCATTATCAGAGTGTGATGATACC	GAGTCTCATGAATCGTTTCAAGGTCTCT
ATGTAATTTATAGCTCTTTTCATCTGCTT	ATTAACTGAGTATAATTTTAAATTGCAGGC
ACAAAACTTTTCAATAACCAATTTGTTTTC	CATTGCATGATAAAGCTCAAATACGAGAG
CTTATCAAAAACACCCTTTATGATGATGAT	GTTTTCACATCACAACCAATTGTTGCT
TTCTTTGGGCTTTTGTAAAAATTTTTCCC	AGAAAACTGCACATAACTCCGAAGGT
AGATCTTTTTCACTATGCACATTAGTTTAT	GTGTTTTCGGCAATAGACCCTATAAAA
CTTGCCCATTCCTGCACTCTCACCAA	ATGCTCTCTGGGGCCATCCACTTCACA
ACTTCGGGCTGGCTAGGGACATC	ACGTCTGGTCCTATGGCATCCTC
CCTTGACAATGTAGTTGGAGTCATTCA	ATGGCTTTGGAGTCCCTGCTGGAGTGAA
TCTCATACTCTGTCTCCTCCCCTAC	GGGCCGTCCATCCTCCTTGTCCAGGTCTA
CTGTCTCCACTTCTTCAAATGACTCCTT	TTCTCCAGCCAAGTAGCCCAGGGCATGG
CCCTGGGACCTCCTCACCTTGCTCAGA	TGGAACCTCCCTTTCTGATAAGAAACC
TAAGACCCTCGGAGCTGGAGCCTTTGGG	TTGAAGCCTGGGGGACAGAGCTCAGGGG
GACAGCATCCTCCTTGCCCAGACCAAA	CAAACTGCAGGTTGTTCCGGGGGAACT
TTGGGGGTCAGAAACAAGGTCCAGGA	TGAGATGGCAGCTCATCACTCCACAGC
TCAGAGCTGGGCCGAGCTGTTGAGTGAAAT	TCACTAGAGCTCTCCTCCTCCAGCTCA
TTCCAGCAGATCTGCTCCTTCCTTCAG	GAGCAAGGGGATATCGCCCAGC
TCTCCTGTCCTCTTGGGCCTGCT	CAAACCCAGTCAAAGTAAGTTTAGTATAA
TGCTGACTGTTGAGACCTTAGAGCA	TTGGCTCCACCTTTGGAGCAGATCCTA
AGGCCCAGGAGCCACTCCCCACGCTGTT	CTTCAGGGTTCCCAGCGCCAGCATGT
TCTGGCACCCTTTTGTGTGCTGCCT	TGATGAGGCCCAAGTGCTGCAGGTCT
TCAGTGTGGCCACTGCACTGCA	GTCAACCCCATCCCTCCAGGCAGT
ATTCTCTCCTGCAGGCACACCTTCACC	TACTGGGAGATTGGGAGGTGGCGGGGAA
CAGAGGGCTTCAGGCGGGGCAGAGAGA	CATTGAGACATGCAAAAACCACCAATC
TCATGTCCCTTCACCATCTGCCCA	GCAAGTTGTGACGGTCACTGCGCTTCT
AAGTGAGTGGGTTCAGGCCTGGGGTGG	TTGCCACTGTCAAAAGGCACCATGGAT
GCTGCCTGCTCTATCTACGTCCT	CAGCAGTGGGAACAGGACAATAGGTGAA
ACAGGGATGCAATCCAGATTCCACCAA	GCGTTTCCCAGGAGCCACACAGTTGTA
CTGCTACCATCCTCAGTTGTCCTTC	GAGAAGACAGTGGCAGCTCTGG
ATGGGTCAGGATCTGTATCTGAGACTG	ATCTGTTCGAATGCCTGCTTGGCCTT
AGTGGCCAGTCCACTGGATACAGATCC	AAGAAGGAGCGCTTTGACCGCTTCAAT
GGCCTAGCTACATAAACTCACATAGTTC	TCCCGACAAAACTCTTCAAACACCTC
GGGAAATGAAAGACTTGAAGGAGAAGAT	GGAAGAAAAGGTGAAACGGCAGAATG
CATGGCCCACACCCTACCAACCTGGTT	ATTGGCCCCACAGTCAGGAAGG
CCTCTCCGAGCCTCATTTCCCCCAACAATA	TCGATGCGGGCATCCCCTAGCT
TTTCTCACCAGCCGGAGTAACTCCTGTGTG	GGCAGAGATAATGGAAAGCATCAAGC
GCTCCCCCTCTAGCTTCTTCTGCTCTT	GATGTATTCCTCCAGTTTCTCAATCCGC
TTAGTGACAGATTGTCCTGGACTGTTCGG	CCACTAGCAAGTATGTAGCTCTGCATC
GGTAACTCTAATCCAAAATGCTTAGGACC	CCAGCTCCTGGGCCAGGGTAGCT
AGGAGAATCAGGTAAGCTCTGGAAG	AGGACCGTCTGGATCTGGAAGAAC
CAGGGATGACCAAGTCAGCAGATGTCA	GCTTCTGAGCATTCTGCAGAGACTT
TCTCCTTTGGGTGAAAAGCCTGGGAAC	CTACAAGAAGCGTAAAGGTGACATGGA
CTTACAAAAGCAAGTTAGGAGAATAACAG	TTCATCCTCCACCTTGTCCATACGCTT
TGACCGGTACCAGCGCCTGAAGGAT	AAATGATGCGGGAGCAGCAGCAGATTGAGA
TTCCACTTCATTATGGTAAAGCTTAAAGAG	TGCTTCCTTGCGTTCAGCCGCAATATT
TATTGCCATGAAGAACCCCAAAGAGAGG	AAGCTACCTCTTGGCTCTGAGGGACC
AGAACGACTAATCTCTTCAAATAGAGCTG	CTGGGCTTTGAGGACAAATTCCTTG
AGCTCAGTGAACAAGGTGCTACATTAG	AGTTGGACCACTTTGTTGTTGATCTTG
TTTGCCCGTGTCATTGTAGGTGGGTG	GGGCATTCTCATCAAAGCTCGTAACT
AATCAACTAGTCTAGCCACCTCCCA	CACCTAGCACAAAGCTGATGGCAT
CAGTCTTTATGGGGACAGAGGAGTAGT	AAAAACCAGCAACCTGCGGGTAAAGACCC
GCTTGACAGAGGAGCTGAAAGTAAG	TCCCAGAGTGACCTAGAACAGACCAA
TGGTGGCTGACCTAGGCTTAGGACT	CACTGTCTACACACAGCAGGGGGAAGA
AATGCCCTTGTCTGTGACAACGTGGAAG	AAGTCAGGAGTGATCTCTGGTGGGGCCA
GGAATCCACACCTTGTGGCGCT	GAGAAGCTCAGTCAGTGGCAGAACACAAA
ACTCGGAGAAGACAGGCCGGGACT	AAACTCCGGGAGCTGAAGGGGGCCAAGCT
CCCCACGCTGCTCCTTGATATACTGAATA	GCTGGCTCAGGAATCCTAATTCCCAGTAT
AAGGAATGCTATGGTATGAAACATTTAAA	CTGGAACTTTTTACCAGTCGGTTCAAG
GCTTGTACTGCAACATCATATTCTTTG	CCCTTGTAGAGCAGTAAGACATTTGAGT
TTAGGATAGAATTGTGTCTATGACCCTTG	TTTACAGCTAGAAGTTGAATTTCTTCATG
TATAGTGAAATTTTTGTGTCCATCTCTTAA	CCCTTCCTCAGTTATTAGCAAAAGTAAG
CAACAAGTTAGTCACCTTTTCTGCATCT	CCTATCATCCAACTGTGTCTTCTTCTCC
ACGTGATCTTTATATTTCACAGTACTCTG	TTTTGGAACGTATTTTAAGAAAGGAAACC
TGTGTCCCCCGTTCCTGTGACTTGCAT	GCAGACACCACAACTCACCTCCACTATTA
GTCTTTGAGCTAACATCCATGTTACCT	GGTGTGCAGTGTTTGTTCTCTGC
AAGAGGAATAAAATTCTCCTTGAAGCACG	TGTGTGCCTTATCTAAAAATTTCAGCA
AGGTATTGAATGACAAAGTTCATTTGTGGG	CATAAGTAAGTTGAATTTTGAAGTTCCTG
CAATTGTTTTGGACTTGACTGTTAACAGA	CAATACCTGATATGCATCATCTTCATCAG
GCTAATTTGTTGTTGTCGTTGTGGGG	GAAAACTGGAATCGAAAATGGAGACATGC
TGCCAAAGGATTACATAGTGAGTACAC	CACTTTGAAAGGTCATGGGCACTGTA
CTTTTTACAGATTGTTATTCACGCACTGC	ATTTGTAGTTTGATGTATATTCAGTGGAG
TACTGTGTGACACCGCCAACCCATTT	AAAAAGGTTTCTTACCGTATGTCCTTGG
ACTCTTGGATTTTAGTACATGTGGAATAA	CCACATTAAAGTGGTCATGATTAACAAGT
TTCTAGCATAAATTCCTATGTGAATTTCCC	TGCTGCCCTAAGGTGCTAGCAAGGTTA
ACACTTCTAGCAACTGGTTCCTATGAT	GGAATAAGAAAGGAAATTTCATCCTAAGTG
ACCATCTTTAGTCCATATTCTGGCAAACC	CTACTTGTGAGTGCCACTAAAGGCCTA
ATTGTGTGAGGTTCGTGGACAGTTAAG	CACATCGCTATAGGCATCGTCATCAT
CTCCTTGTTGTTGTTGACAACTGTGGA	CTTACCGTGTTATAACATCCAAGTATCTG
TCTGGTTCTAATGGAGGGCAAATAAGAG	GCAAACAATGCAGCTTACCACAAACAG
CCAGCCTGTCATGAATGTATAGGAAAAA	CTAGTTCCGTAGGAGGTGAACAAGTTC
CCCATCCTCTGTCGGCCTTGGC	TCCTCCATTTCTGTAAAAACCTCCTGA
GAACTCTGTGACTGATAGACCTGTTGA	TCTGTGACAACCTGGGAGACCACCTGG
TTTTAAATCCTTCCAAACAGATACAGAAG	AACACACACGAGATTATCTAGAGAAAAGCC
ACTATGTTCTAAGCACTGCCTTTTAAA	GCAGAAGCCGCCTCGTGTGCATTCTCT
CCGAGCTGTCACCCGTGACGGA	AGAGCTGCGGCGGGAGCTGTATGGCCG
ATACTGACGGCAGCAGGCTTCTCTGAA	CAGAGAGAGATATACACACTCAGGT
TCTGGAGGGAGGCAGGGAAGTTACCT	TTCCTGCCTGATCTGACGAGGGAGGG
CCCACAAGCTGTTCATCGGGGGCTTA	GTGGACATCAACGTCACGGATCA
CCATCTCTCCACTTCCAACACCTAAA	ACACTCGCCCTCTGGACCAGCAGCTTC
TTTCATGGGAAGGCATTTGGGGG	GCAAGTGCCGGGCTTGATGAGCT
ATCTCGATGGACTTGACAAGCCC	TCTGTGGGGCCAGGGGAGGCAGCGGCGT
GAGGACGTGCGGGACGAGTGCAGCAAGTA	CTCCGCGCGCTCTTTCTTCCTCTCTCT
TTGAATGACCGCTGCTTGATCCCACAG	ATATCTGGGTGTGGCCATCTGAATCCATC
TGCAGGCATGCCTGTGGCTTCATGAAT	TTTCCATTCCGTCTTATCCTGCATGT
GTTATCAGTGGTGAATCAGGCCAGAAT	TGAATGGGCAGGTGCTGGTCTTCACCC
CTCTTTCAAACTGACCCACCCAACA	TGTTGAGGGATTTCATTGGGCTTGCT
TTGCAGGTGACCTGGGATGGCCACTC	AACATCCCCAGCTCGGCTCCACCCATCAC
CTGGAGGGTGATGTTGGCCTGG	GATCTTCTTACCAATGGCTGTTTCCTC
CCTCATCCCATGGAACCAGCCT	GTGAGGAGGAGATCCAGAAGCCA
CTTGGCCTCTTTGGCCCTTAGC	TCCAAGGGCACAGATGTCTGGGA
GGCATTCAATGCCTACAAGGCGCA	CTACTCACAGCTTATATGCTCCACAGG
CAAAGCAAAGACAAGGAAAGTCCAGGA	TAGACAGAGAACAGAGACCCTGGACCT
TTGGCAAAGCGGACATCAGTGCTGAC	CAAGATTGAGGAAATGCAGGCAAGAGA
CTCTATGTCCACCTGGATGGAGCTATA	AAGTTCTATGTGGAGGAGTTGAAGGC
GGATCACAGTAGATATCTGCTGAACCAAG	AATAAGTCCAGAGGGGTGGAGCCTGTAAG
GAGCAGAGATCTCTAGGAGCAGGACA	GCATAGGGGAGAGGGGACCGTGGACT
GCCAAAGGATACATACTAAGTCCTTGCTC	CCCCCAGAAGACTCACAGCTGG
TTACTGGGGCTGGAATACGGGAGGCATA	CTTTGGAAAAGGGGCCTTGACCACCATT
AGCTGAAAGGAAGGGCCAGAAAG	CTCTCCTCACCCCAAAGATTTAACTATCA
AAAACTGGACTTAGACTTCCTCAGAGC	GAAGGAACTTCTACCTAAGCCCCTGCTAT
TCCCTGTCCTTGTCCTGTTCTTGTTC	CTTGTGTCTTCTCTTCTTAGTTTTCTTTT
TGAGAGTGAGACAGACCCTGAGGAGAAA	TGTGCCTTTGCTCCAACAGACA
TAAGGAAGAAGTCTGAGGCAGACGGTG	TTCACCCTTAGCCTGCACTAAGGGCCG
ACCATTACAGACCACACTAACAGAAAGG	GCGGGTCTCTGAGCTCTGCCAGGGTCTTAA
AGTTGGCTCGCTTAAATGGGACCC	TGTGGAGGGGCTGGCCACATTGCTTC
CTTCAGGTCTCTACACTCTCCTTTAAAC	CTAGGTTTCTGCTAGGAGGCTTCCTTT
GAAAGGGTCTGTGAAAGAAGGGAAG	GCATTTTCACTAGATAAGAAACATCCTGAA
AACATCTGGCCATCTTTGCGCCCAA	CAAGCGCAGAGAATTGGATTTTCCCA
GTTTGAACCAGGCCAGGTGGTAGCTAAA	AAGAGTCCCGCTGGACCCGGCCCAA
GCAAGTCACTCACCCTGCAGCC	CCTGTGTCCGACTTGTACTCTTTCC
GCCCCTGTGACTGACTGTGTTATCTTT	CCTTCCCAGGATAGAGAAACCAGCCA
TGGGGCCAGGAGGCACAGGTGGG	AAGGAGACAGAGCTGGCTCTTCCTCC
AGCAGCTGCCACAGACACTTCA	CCCCATGGCATTCCCAATGTTG
AGTGCCCTGAACTCCTGGCAACATATC	AGCTGCTGCAGGAACCCCTGTT
ATCTGGGTGTGACCTCTGAAGGGCAGAAAA	AGTTGGAGCAACCGGGAGAAGGCAAA
TGACCACCATCTTCATGGCCTGTTCC	ATTCCTCCTCCTCCTGCTGTGGCTGATGC
TCCAGGCTGTCCCCTCCAATGCCTCAT	GGGGAAGAAAAGCTGGAGGGCCT
CCACAGTCCTGTGGATCTCTTCCAGA	GCTGCCGCACTGGACGCAGGCAACATCAA
TTAGGGTCTGGGCTTCTACCACCATCC	AAGTCCTCAAAGGCCGTGTTCACCTC
TGTCTTGCTCCATTCCTTCTCACTCA	AGCGGGAGAAGGAGGAGGCACGCAGGAT
TCAGTGGTGAAGCACCGCTGCCCTCAG	AGCTGAGGAAAGAAGGGACACGGAA
ACTGCCTGGGAAGAGGTCAGGA	CAGTGCTCTCCTCGTTCAAGGTC
AACTGGTCTAATGAGTTCAAGGGCCTG	CTGGACACCGCCATGAGCACAG
GGAGTTCCTACAGGTGCTGGAGGTGA	GCCAGATTTTAGGAAGTAGGATCCTTCC
TTACTCACTGAGGGTGAGTGGGAACGCTT	TTCTGCCTATCCCAGGGATCCTCAGGC
CACCTCCACACCAAAGGCCGAAAGCAT	CCTCCTCTCTCGAATTCCCAGACGA
TCCAAGGGCAGCACCCCCACTTT	TTCCCTCCAAGGGAGATATTGTAAGGG
GAGCCCTCTTCCTCACTTGATTCAGTT	CCTGTGGAAGTAGAAAGAACTTCCTCT
ACAACCCCAATGGACCCCCACCC	AATGTGCTGGGTCTGCCTGGCTTGCCAGGG
GGTGCCCAGGAGGGTGGGGGCCCTGGTT	TGAAGGGCCAGAATTCATCCAGG
TTCTCACTTCGGGAAGACCTTGTTC	AGGTGGTCCTGGTGGGCCCGGAGGTGG
CTCAGGATAAAGCACGGATGGATAAAGA	TACTGCAGAGACTGGGAGCTATGGCCA
ACCCAGTTCAGCCATGAGGGACAAATA	TTCTAACCCCTTACTGGGCATGGCTCT
TTCAGCCAAAATGAAATGTCCTACCAA	TCACACGTGTTGCTGGAGGTCTAAGAA
ACCTGCTGGGATGGGACAGTATT	TACCCAGAAATCAACTTTGTGGGGCTG
CAAATATTGGTACCAAGTGCTAATTATGGG	CAGCTTTTTGCGGGTGCGGAACTCT
CCTCCGAAGAGTGTTGTATTAGGGTCT	AAGAGGAGCGGCACAACCTCATCACAG
TCCCTTCTCTGGTTGTATCTTCCATG	GAGTTGGTATTGGTGGGACACAAATTG
CGTCTTCCGAGACCTGGTTGGT	CACAAGTCAGAAGACAAGCCTGACGAT
ATTTGGGTGTTGAGTGGAGTCCAGGAGC	TAGCACTGCCATCTGGGTCTGCCCCC
CGGGCTCAAGCTTCCCGCATCTGACA	GAGGGGACCCTGCCCCTGGTTACCACTAA
CAACTTGGACTGGAACAAGCCCT	CCAAAATGAAAGTATTCTTCTCTCCAACAC
CCAGATGCATTCCAGGTTCCCCTCT	TGCCAGCTTCTGCTCCCCCTTCA
ATGCTGGCATGGGAGCCAGAACCGGAG	AAAGGGGGTTCGAGTCAGAGATGAGCG
CAGGCTCCTGTGCCCCCTTCAG	CCCCAGCCCCCATCTTTACTCCA
TCAGCACTGTCCCTGGCTGAAAGGA	AAAGGCGGGGATGAGGGTGGGGGTAGA
AGTAGAGTGTGCTTTCCTGCAGCT	CAGGACAGGTGTCTCCCAGGCGTGCTA
TCCAAGCTGGTATCTCTGGAGGTGAA	AAGATGCCCAGTGGCACCGAGCAGCAAA
GCTGGTTCGGCAATGGAAGCTT	ACTGGGGGCTGGCAGCAGAGGCTGTGG
ACCTGAGTGCAGCGAGATGCCCCTTGAT	GGGCTCCACTTCCTCGCCCTTTGTCAT
CCCAGGTTGGGGTCTTTGTTCAG	TGGGTTGTGCGCTGAGACCTAGAC
CATTCCTGGCACCTACGTGGGAGT	CAAGCACAGTGAAACGATATACTCCAG
TACGGGGACCAGCCAACAGGCAGGAC	TTTTTGCCACACGTGGCACCAGTGCCCTT
GGCCGGCAAATATTTATCCCCGGTGTT	AGCTCCAGCGAAGCCGTGCACGGACTT
CTGCTCGGAACCACGTCCAATATAA	AGTGCTGTCAGAGCAGAGGTGGCTC
CCTGCCTAAGATGCCTGAGCTGCCTTT	CCTCCCAGTGGCTCCCCAGAGG
TTCACTGTCCTTCTCTTTGCCGCACTT	AAGACCACATCACCATCCACCTTCTCCA
GACGGAATCTCTGCCGCCCAAGAAGAT	TGACACAGTGCTGTTGGGCAGCTGTGT
AGTGATAAAATGTTCCTGGTAGTATTAAAG	TTTGCCGTTGTAATTACTACCGGTACT
GATATGTGTGGCATGTAAGCACGTTT	AGTTTTTCTTACAAGTAAATTTTGTTTGGA
CCTCTTCTGTCATAGGCCATGAGGTCT	GATTCCGAGCTCTGCTACCACC
ACCTATGATTATGGTGGTTTTACAATGAT	TTCCTCCACCACCACCACCTAGAGGGGG
CACTGGGCGTCCGCGACGGTCATCAAA	AAGTCATTCCCCCATCAGGAGGTACTA
GAGGGAAGCTCAGAACCTGCCCCTT	TGGGTAGCTTGGGTGCTGTCACCAAA
AGGTTGGTGTTGACAAGAATGGACC	GTCCAGTCCATCCTAACCTGTATATTCTT
GAGGGGAAGAAATAGATTTTGAGACACC	GGATGGCCTGTTGCGTCTCAGCA
CTTATACTAAATAACCCTTTGAGAAGAGC	TCCCCACCTAGAAGGATCAAGGG
