TGGAGCTGCCGCCGCCGCCGGGGAGAA	GCCATCTTCCTTTAAGAACGGGACA
CACACTGAAATTAGGACGTTTATATTTCT	TGTCTGGTAGTGAGATGGAACTATCCA
CCCTCATCCATTCTTTTGTGGTTTTAC	CATTTCTCATATGCAGTCAGGTGACAC
CCAACTCATGACTGTCCTTTCTTTGTTTA	GATTGTACAACAGATAGCTATTCTTATGG
CTACTAAGGAGGCTGAGCAGGAGGAT	TAATACCAGTGTGTCTCGCTTGCCA
TATTCTAGAAACAAAAGGCAGCGCCTC	TGATTCATAAAATGACCACTGCTCAGA
GGTGCTAACCATCTCACTCTCTTCTAG	AGTGATCAATCTAAAGCATCGTTGCC
CCGCCACACTATGATGTTTAGTGCTA	GTTTGGGTGGAAGAATCAGACAAACG
ACCAGGTTGCCTAAGGAGGGGTG	ACTTTCTGTGTGATGTTTTCAGAGGTA
ACTCTGACATATGGCCATTTCTGTTTTC	TGCAATTCACTTGAATTTCAAATATGTTT
AGGCATTTCAAGTACTATGTTTAGATATG	AACAAAAGTGAAAGCAAAGATAGATACTT
TCCAAACTCTTCTCGACCACATCAC	TTTCTGTGAGTAATCACAGGGTTAGAA
ACACACAAGCCTTAATATATATGTAAACC	TCTGTCAGAGCGTTTTCCATTCGCA
ACAAAGGGGCGCCTGGACCATG	GTCATCTTGTGTGTGGACATTCAGGAA
CGCGAAGCTAAGCCTAAGAAAAA	ATGACTACACACCATCAACTCTGAGTC
AGGAGAGGGAAGCTAGGCGCCAA	GTGAAGGAGAGTTGCATGTGTTCCT
GCACATGGGATGGGAAGTGGTTG	AATGTGGTGCGGCAGTCCCGCAAGT
AAATCAGCCCCCACTGAGTGTCCTCA	GGTTTGAATATTCACTCAAGACCACCC
CCACACACATCCCTACACTTATCTCTC	ACTGAAGGGCTAGGCGGGGCATTT
GCCAGACCCCTGAGGTGGTACC	GGAGAGACTCTGGGGGATGGAAT
ATTTTACATCAACTGCTGTACTCGATCAG	ATTGGACCTGAGAGACTTGAAACTGAC
CTCTTTATTCTTCATGATGTTTCCTTCG	CATTCTCTTGCTAGGCCTCTTGGATAC
AGCTCATCATCTGGGACAGGGC	AAATTCAGGGCCCCTCCGCTGCT
ATCGTGAGGCTGCTGGACGAGTACAAC	TCAAGGCACGGAGGAAGAAGTCC
CTCCGTGCAGCTGCGGGCTGCGCACCA	GGCGTGGGGACCCTCCCCAAGGTTCCAT
CCTCGTTCTTATTTTGTATAAAAACATGTG	GTCGGAGACGTTGGAATGCGGG
CTGCACAGTAGCCTTGCTGCCA	TTGGCGTGAGCTCAGCAGCCAG
GCCCAGGTGGGTGTCGGGCATC	GTCCTTGGCCTCCTTGCTTCCACA
AGGCGAGGAGTAGCTGTGCTGC	GCTGTGGTGGTGGTGGTGGCGGCT
TCCGTGCCCCTCAACCACCTGCCT	ACTGTGGGCGGGTCCACCAGTTTGAAT
TCCCACCCGTGACCGCAGCCCAGT	AGCATGCAGTCCCAGATCGCCC
TGATGCCGCCGGAGCAGCTGCGCAACAG	AGGTGAAGGCCTCGCTGCTCCC
AGCTCCCGCAGGAAGTGGAAGGA	GCCTCGCACCCGCCGTCCGGTGCCTCCA
CGTCTCTTTTACCATAAAGTGGGGAGAG	CCCAGCAGGGCGTCAGGTGCGG
AAGCAGCAGCCAGGAACATGAGCTCTTA	CCACAAAACAACTGAGCTAAGCATGAC
TAAGTATTCAACGAGTTTCTGAAATTGC	ATAAATGGCTTAACAGATTACTGTCGCG
AGGAGGAAGGATAATCTGAACCCAGGA	CCTCCTAAGCCACTTTTTATATCTTTCAG
TAAAGTGTATTTATTGTAGCCGAGTATCT	GCTTGGGCCTTTGTTCTTCGAGACGTTAT
TGAAATACCTTGTTTCTTAATTTTGTGTC	ACCATTCCCTCTAAGAAATGGAAATAC
GCCTCCCTTTCCAATGGACTATTTTAG	TTTTAGTGACCACAAAGTCTGCTGCTC
TGAAAACACTAATGTAACATAAAGGTAACA	GCAAACATACAGAGGTAGACAGAATAG
TTCCCGAGGTTTCTCAGAGCCTCTCT	CACACCTCCCTGGTCCAGCAGCTAGT
GCGCGTGAGCTGAGGCAAGACC	TGGCCCAGCTCCTCAGCCAGGT
TTCTCTCTGGCAGGTCATGATGATGGG	GATGTCGCACGGTACCTGCGCG
AGCAGCTCCGCCACTCGGGCGCT	ATTATATCCTCCGAACTTCTGCGGAG
CTCCCTTTTTATCCCAAACGTTCGT	GAAAACTCCCCAGGAAGCCTCCCCTTTTT
CGTTGGGCAGCGCCCCCGCCTCCAGCA	GAAGAGCCCCCTCCGACCCTGT
TCGGGTAGAGGAGGTGCGGGCG	GGTTTGTAATCACAGACCTCCTCCTG
GACAAAAATATTCATTTATTTTGTCCTGGA	ATAGCTTTATTATCTTTGCCTCTTTTCTG
GGAAAAATTTGAATACATTGTGTTGGGCAA	ATTGCATCAAATATCATGTACATAGTAGG
GTGTTTTCTTGCCCTTTTCCTCTGTAG	GATTGGAGGATAATCGTCTGTCTTCTGC
TTTTCTCCCTTCCTCCTTTGAACAAAC	TGTTAAGATCTCTACCTGCCTATCGGA
ACTTCCTGATCTCTCTCGCTGTGAGA	GTACCCTTTAGCGTAACCTTGCTACTC
GAAAATGGAATCTCTTACCTCCTCCAC	GAGTGGAAAAGGAAGCGACCCAGAAAT
CAAAACCCCTCCCCACCAGAGGACTCT	GCCAACTGTTACCTTTTTATATAACAGAG
TGAGCAGCGACCCTGATCCCTAACA	TACTGGAAGTTGACTTTGTCCACCTGG
CCTGTTCCCGGGATGGGGCCACACTTA	TCCTCCCCCGCCCACCGGCCAGGGAT
CGACGGCTGCGCAGGTGCCCGCAGT	CACACTACAGGTACCGCCCCCG
TGAGCAGCAGGAGGCGGGGCTGTTCGA	AGGAAACTGCCACCTCAGCAGCA
TCCCCTCTTCCTGCCCTTATTTTTAAC	GCTCTGAGGTGGTTTTCACAGGACTT
CTTTCTGCCTCATGCTCTCTCCAACA	GGAAAGTCTCTTAGTTAGTGGTTGGTC
CTCGATTTCCCTTTCCTTTTTCTTTCC	TTGATAAGCTGGTCTTCTTCGTGTAAG
TGGGCAGTGATTATTCTCCATGGG	AACAGTTCAATGGTGGGAGGGTTATG
CCAGGAGTCCTACCCTCTGTCAGTGT	GGAAGGGAAGCCCATCAACCTCTCTCAT
TCTGGGGAGAAAGGTCCTTTACACAT	ACCGCTCCAGGTCACCTATCACGACAAAT
AGAGCCTTGGAGGGCGCCTAATTGGG	TATGCAGCCCGTCCTCGGAGAGCCT
CCCAACCATGACAAGATTTTCCCTTAC	AGATGATTACTTTTGGGTAGAAAGGAA
TGTGAAGTGTAGGAAGAGTAAACTTAC	GAAAAATGAAGGCATAAACAGGAACAG
TTCTGTTACATTGTGCAGAGTTCAGTT	GAGTATTCCATCTCTCTGCTCAAAACC
AACATATTCTCTATGCAATTTTGAACCTT	TATTCTCCACAGGATGAGATACTTGAT
CACCCAATGAAGAATGTAATTGATAATCT	CTACACACAACCATAGTTGATCAGGGT
GGTAATGCATTATATTTTAAGATTTTGCCT	GAATATGCTTCATCTTTTCATCAAGATCA
TGTTGGGTAGTTCCTTATGTAATGTTT	ACGTTACTTTCTTGCTGTGTTACTCTC
GCTATTCTCAGATGACTCTGTGTTTTT	AAAGATGCCATTTGGTTGGGTGAAGTG
TTTCCCATCCTCTTCCCCCTTTCCTAC	CTTGTCTCTGGGAATGCAGATTCTACA
TTCATAAACTTTTCTGAAGTAACCATTCTG	ATATTGTCTTTGAGTTCCATTCCACTTG
TTTTGGACTGTACTGGATCAGCAATTTG	ACCCTCCTGCCATCATATTGAACAC
ACCTTGACTAAATCTACCATGTTTTCTC	GTTAGTGGAGCATATGATTTTATGGTAAA
AAGGGTCCTCTACTGTATTTGATTTTT	AGCCAACAAAACTTACTGTAATAAATGATA
AACTCTGGAATAAAATTTGGTGTATTACC	ACTCACATATCCCTGATCATTTTCATAG
GTATTTGCTCAGAACTTATACCACGAA	GGAGACAGCTCACAGTTAGGTAAACTT
TTAGAGTACTATGGAAATGATGGTGATTC	TTACTGATGATACTATCTCAGCTTCTACCC
GCTTGGTTCTTTGTTTGTCTTAATTGC	ACAAATGTGGAAATTAAGGCCAGGTGC
GTCACTATTGGTAACAGAAAAGCTGCA	AGACACTCTGAAAATAAAGAAGAGGTT
AGTGTATCTGACCTATTATCAATCATGTT	CTGGCTTAGCCCTTAGAGTTTTAGTGA
CTTGTAGGTAATGTATCCTGTTCATCT	TTACTTCTGCATGGAAAAATTCTTGGATCC
GAAGATGGGTTGGTTACTAACCACATC	GGAAAACTGGTTGAAAATTTTGGCAAACA
GCCACCTTTAACTCAGTTAACTGAACT	GAATTATTCCAGAAAGCCAAGGTAGGAG
CATCATGTACCCCAGAACTTAAAGTAT	GACTTATATGCTTCCTCTTCAGCTATTAC
AAAGGAAAGTCAAGAGGTAAGATGACA	AAATCACTGTCCTTGAGAAGCTGGGAG
TCTTGTCACTACAAAAGTTCCTTTGTA	AGTTTTCAGGAGCCTATCATGGCTCT
TCATTAAAAGAGGTGTTCTTGTGACAAAC	TGAATTTACTTACTGGACTAAGCATCA
CTTTAATAAATTTACAACAGTTTGAGTGGG	AGAGGAATCCACAGATTTATATCATCC
TGCCTCCAGATTTAGTTTTAACTGTAT	AGTGAAAATCATGACATTTGGATAAAGAC
TTAGTGAGTAGGAGGTTTCTGAAATGTG	GCCCTATCTGCGAAAAACAGGCTTT
GTTTTTGTATAACTGCTTTCCAATATTCCC	ACAGGATAAAACCACAGCTATCAACGT
ATAGTCCCTGACAAGTAGTTAAGTCCTC	TCTCAAGCAAATGATCAAGAAGTTGGA
TGGACTGATAGAATTGTGATATATAGGAAA	TACTCAGGGCAAGACTCTGCTCCTTTT
TTTTCCCTGGGATAAAAACCCAACTTT	TTATATCAACTGCTTATTAAGTGGAGAAGA
TAGAGCACTGGACCAAGTGCTAGG	TTTCAACTGCTTTACATAAGAAGCGTT
TCTAAGTGAAGCTTTTTGTTTTTCTTTGT	TTGCAACTGTTAGCCAGGGAAGAGGTT
TAGAAATTTAATATGTCAACGGGGCATG	TCAGGGATTTTTCACCAGCTGTCTTC
TTATCTCCATTCCATAGATGAAGAAACA	CATGTGTAGAAAGCAGATTTCTCCATG
CTCTTTAATGGCCTTTTAAAATTAAAAGGT	TGGCTTATTAAAGCTGACAGCTGTCAG
TGGGATTACAGGTGCAAAGAACCATG	AAGAATACAGTGAAGTTAGGAGGTTTG
AAGTAGTCTTTGAATGATGTAGATACTAGG	GAGAGAATGTGGTATAGAAAAGCACCAG
CATCCTTGCTGTTTTTCCTGCCC	CAATGGTTAAAAAGTCCATCTTGTCAAAA
ACTTAGACTTCTATGTTTGAATGAAGAAG	GAATTCGAAAGTTGACAGCCAAAGTCT
AAATTAAGACTACTGTTTGAAAATTAGGGT	AGTGTGTGAATTAGGAGATGAAATTCTTCC
CAGGCAACAGAAAACATACAGTAAAAAT	GTTTAAACTAGCATGAAGACAACACTT
TCACTTTTTGTTTGTTTGTTTGCTTGC	TAATCCAGTAGTTTACAGTATAAAGCTGC
TTTGTCTAAGTTAATTTGTATCTTTGCTGT	TGGAGGAATATGCAGTGGGACCATT
ACACACATACACACTATATATATGGTATGT	GCTGCTTGGTAATGAAGTTCTTCTAGT
GCTGAGAGCTTTGTTTAGGCACATTTTT	ATACTGCAGTGGGTAGAGCGTGTATG
AGGGTCAGTTCGATAACCATATAATTT	TGAGTAGTATGTTGCTACAATCAGCTC
TCCCAAATGGAATTATTTAAATAGTTGCC	AGACATTCTTTCTGTGAGAAAATACTGGTG
AAGGTTAGATCTGGGAAATTCTGCATT	TTTTGCTCTATTCCCATTTTTACCGTT
TTTAACAGTTTTTATGTTCATTTAGTCACC	ATGTGTGAAGTAAATAGAAGCTTTTCTTT
TTGTCATGGCAATCACATATCCCTTTG	CTTCCTTTTGCAAGGGACACTGTAATC
TGGGAGGTAGAGGTTGTGGTGATA	AAATAGAACTAGGCTGGGAAGTAATAAAAG
GAATTTGCATTTTTCCTTCTATTCACAAT	CAGTGGGATTGTCACAACTCATTGTAG
GGGACTGAGGGGAGATATTTTTGTTTG	ATTTTAGGTGAAGGTGTTGCAAAGTGT
ACATGTATATCTTAGGGTTCTGTTTTTAAG	ATGTAAGGATTTGCATTGATGAAGAGA
AAATCCGTATTTATAATGTGTTTGACTCT	TTGTGCACTTAGCCTTTTCACACATCC
CTAAAATATCTTTTAAATGGGGAACAGGA	GCTACCTTGGCAACTTCTAGATAATTTAA
AAATGTGGTTTTTGGGAATTTGTAATTTTC	CAGTCTTGTGCTGCTCACTTTACAG
GCTCTGTAATTGATTACAAAGGTTAATTC	CATCCTTACAGTAAGTCACGGCTGT
ATGTCAAGGCATATAAGAATTAGAGATGC	TCTAGAAAACCATCTTCATGTTATTGTTGG
TCAGTGATTTCAGATTGTTTGTTTCTT	ACAAATATAAGAGACAGATAAATTGAAGCA
TTTTTGTGAAGAGGAGGAAATTTGAGT	GTCCTTTAGGGCAGCTGATATTCGGA
CTAGTCTCAGGTTCATTTCTCAAGAAA	CAGTATTGGTCTGAGCAGTAGTTACAC
AAATATATTTTAATTTTGTGCCCTTGCAG	TGGTTGACACCTTCAATGTCTATTTCA
AATTAGTGCAGTTTTAAAATCCTTTTTCTG	GTTACCAAAGGATGCTGTTCTCAGAC
GGACTTGGTTGTCTCTTTAGGAATCCAC	GCATGAATTATTCTAGCCACTAAAACTCT
ACCTATGACTCTACTGAAATAGAATTTCT	ACATTCATGGAGAATGATACTTCACAC
CACACACATGTGTATGGGTATGGTATGT	TCTAAATGAGATGCCATAAAGTCTTCT
ATAGATGAGGAAATCAAGAAAAGTTGAATG	TATCTGGTTTTGGAATGGCTAAATCTTC
GTCACAAGATTCTGTTCTCATATGTAACA	TAACTTGGTTTTATGACAATTGCTGAT
TTTCAGTAGAAAAATGGTTTTTGAATTTGG	AAAGCATTTTAGAAATTCTTTCCAAAAGCC
CAGTTTGTCACTAAAATCTCTTCATTTTT	TGTAGGTCAAAATTGGTTAAATATTGGC
GGTTATATCTCATATCATTCAGGGAATGA	CTGATTAGCAATGGACTTCACCTCATC
ATCTGGATAAAGTATGATACTTTAATGCTG	TTCAAGAGGACTGGAAAAGTCTTCTAAC
CGTGTTAAAAGCAAGTTACATTTTCTC	TCATTGTCACAGACTTAGTTCAGACTC
GTGTACTTGATAGGCATTTGAATTGTT	AAACAGTTCTGTTTGCTGTGGGTCATG
TCTTGAACATCTTTGTTTCTCTTCCTTG	ATTGATTTGGCAGTATAAGAGGCCTCA
AATGGAAGGTTGGACCAGGTGTCTT	TATAGGAAGTAGAGGAAAGTATTCTTCAGG
GCATGTACAGAGTCATTTTATAGGCTTTT	GACTTATCTCATTCACTAGCAGATCAT
GCATTTTGAGATTTTTGTCTTTCATCATTG	CATGTTGAAGTAATGGTATGCAGTAAG
AAGTGTTGTGGTTCCTTAACCACATTTC	TTGCCAAGAATGTGTTGTCCAAAATGC
ATTCCAGTATTAACTTTCAGTAATTACCCT	TATTATTGATGGCAAATACACAGAGGAAGC
CATTCCCTGTGGTTTTTAATAAAAATTGAA	CAAGTCATTTGCGGATATTAACCTCTACA
AGGGTAAGGGGGCAGGGAGGGAGGGAA	CACTGTGTTCCTGGAAAAGATTAAGAA
AATGCCTTGAAATGTATATAAATCTTCTCA	TCTTTTTCCTCGTTTAATCTCCTGAAG
TTAAGGAAAGATTATCTTTCTTCGGAAATT	TGGTCTGTAGTTTTTATATTTGTTATGCA
GGCTTACGATTATTTCTCTTTCCTTATAC	TACTCAGTCTCTGTTCTTAAATGGTGT
GTCTCTTTTACATAGAGAAAATGGACTTAG	TGACCTATGTCCAAAAATATTTTTGAAAC
CTTTATAAATTACCCAGTCTTGCATATGTC	CTGAAAAATAAAAGTGTGTGTGAATGC
AACCTGAGGATGAGCAGCTTCACGTT	GCTCAAATAAAAATGAAAAGGAAAAGTCAG
CTCATCCACGTCAGAGACTTTGTATAAAG	GTGGCCTAGTTGATCCAGATCAGTG
AGCACCAGCCCTATGAACTTCTATTC	TGTATAGGTATCCAAGCCAAGACCCT
AGACCTCATCGTTGTCCTCTGCA	TGTTGAACATGCCCGGAGCTGCA
GCCACATGAAACTTCAGAGCCCACTTA	GGGCAGTGGGGAAAGGTCACAGTATT
TGCTTAATGGGTGTCGTATATCACTAG	AGCAGCAGAGACCCCAGCAGCA
GGGATAAGGAGGCAATTTCCCTACATG	ATCCATCGGCTGAGACTGGGGAGAATA
ACTAGTCCAGGGTGTGGCTTCT	ATAAGAGCATGAATGAGCCAAAACATGG
ATATGAACCTGCAGCTTGAGATGAGG	TGGGGCTGTGGTGGCTGCTTCT
AGCAGTTGTACCATTAGACCAAATGTAC	CTCTCTTCATGCCCTGCATCTCCAAAA
TTCGGCAAGAGACTTGATGAAACGCAG	TGGTAAAAGACGAGGGAGATCCTGGT
TGGTGTGAGGGTTTTTGGAACTGGA	GTTGATACTGAAGAATTGATGGCAGTGAT
AAATACTCCAGACTTTTCCTCACCCC	CATGAAATCAAGTGCATGCAAAATACAGG
GTTTTGTTTTCTGGTGGTGCTGTGTG	TCCCTGGTCAGGCACAGGAAAAA
CACCTTCCAAATTACTAGATACTCCTATA	AAGTTACCGATGCTTGTGTCTTGTG
TTTGCTATGTCTAGGTATTCCGATATTT	GAGGGCAACAGACTAAGTCCATTCCT
CTTTAACTGCATTTTCTTGGGCTACAG	CGTTTTATTCCTCCATTTTGCAAACACT
CTGTCTCAATATTATCCAGATTGTGTTTCC	TGTGATGCTGATGATGCTGATAATGCC
GTGTTGTGTTACTTTGGTTGGGGTAG	AGCACCATTCATTTCATTTTGTTTTAAATA
AACTGCCAGCAGTTGATGAGAAAC	CAATCTCTCCAATCAAATGACCTCCAA
CCTTCTCTTTGCTGATCATTGTTGCTT	CCTGTTGATTCAAGTGCTGTTTCAACAC
CAAATAATGTGATCCCAAAGCAAGATC	GAAGTCACACTCAGACCCCTCCCCAGAA
GAGTCTTGACAGGTGTATCCAATAAATTTT	CTTGCTTCTGTGATTTGAGAGTAAGAG
CTTCATACAGGGTATTCCATAATAACTTTT	ATCAGGCTTGCTTCGGGGCCATCCACA
AGCAGTCAACCAAATGTCTCCGATTTG	CAAGGCAGTGCTAATGCCTAATGGT
ATTCTTCACCAGACGCTAGCTTTGTGG	AGGCAGCTCAGAGTTAGAGGTCTGTG
CTTCCTTCAGAAGGAAAAAGCACTCTG	TGTGTGAACAGGAATGACATACAGACTG
CACTGCCTGAGAGAGCTCATCCAGAA	GGCTCCTTCAGATCAAGAAATTGAAAC
CATTAGTAGCCTGACTGTTAATGGCATT	TAATTAGCACTTTTCCCCTCCTGCTC
AACAACAAAAATCAGTTTTTGAGATATGCC	GATTCCTTTTCTGCCACTACCACAC
TCGACCCTTCAGAATCTCTTGCTCT	TTTCAGAAAGCATCGGAGAAGGGCTGCA
CAGTCCCAAGGTACAGTGGACCAACAT	TCAGAGACTGAGCCATTTTCAAACTCAC
CCTGTTCTTGAAAGCACCTGTGAAGA	CTGACTATAAGGGGAATTTCTACGATTTAT
CTGGATGCAAGCCACATGCCTGTAT	AAAAGTTGAAATGTCAGGGCCAGTCAC
GCTTTGTGGATGTAGCCTTTATATTTAG	GTCAGAATTTTTCCAGCCTTCACACAC
GTGTGTGTGTTTCTGTGGGTTTCTT	CCCAGATCAAAGACTCATGCCAGTTA
GTTGCCCTAATTGTGATCTAAACATGA	TGATTCTCATCCTGGTGTGGGAAGGAA
AAGTGCACGCTGAACTCTCTTCCTTTC	AATCACTGCAGCCTCACAGGTGTGGCC
TAGCAATGAATTTGGTCTTTTGATTTTTC	AGCTTAGATGAAGTGAACAATATGACA
CACGTCGCTCTGGTTCGGGAGG	GTGTGGTAGCGCGTGGCCGAGCCCAT
CAACCTCCTACTCACTTCCGCT	TACCTGCCGCCGCCCTACCCCGGCTCG
TCCACCGGCTCCGCGCTGCTCAACCCC	TGTTCGCGACAAGCCCGCCGGGATC
CACAATAGGACATCGGCAGAAACTAGAT	ACTGCCCGCCTCTCCTGCACCT
CCACCCACCCCAGACCCACCGA	CACACACGTCAAGCAAAGTGAAGATG
AGGACAAGCTCCCGGGCTTGGTCTGAT	GCAGAATGGGCCCCCTTTCACC
GGGGATCTGGTTACAATGCAGATCTGA	GCTCCATCTGGTACTTACCCTGCATCT
TGCTGCCCTGAATGGTTCTAACATATG	ACCAGCCTGGAGGGTGTACCAG
AACAGATATGTTCAGGCCACCAACCTC	TACTCAGGGACCATGTCTCAGATTCCT
ACCACCCGGGCGAGCTGGTGCG	AAAGGGGCCCCCGCAGCCCCGGGTCGGT
CAGAGGAAGTTGGGGCTGTCGGT	TAGGACCCTGCAAACAGCTCCTA
AGTAGATATTACAAGACCAGCATGTACTC	TCTGGGACTCCCCAAGCCCTATTAAAA
GTGGATCCCCTCTCCACCCTGGCCTA	CCATCTTTCAACCAGAATTTGAACCCC
AAGACTGGACAGCGGGCACACTTA	TGAGCACTGGAGTATATCCAAAGAAGG
GGTCAGCGGGCTACCACTGGGCCTCA	GAAATGAAAACCCTAGTGTGACCTTCC
AAAAAGGCCTCCCCTGCTTGCCACAGG	TGCACACTGGCCTGCTGTGCCCC
AAATGGTTTTCTTTTCTCCTCCAACCT	GTAAATCCTGTCTAGGGATATCACACA
CAGTCAAACAACAATTCTTTGTACTTTTT	GGATCACAGCTAGGTGTCAGTGTAAAC
GAAAAATAAATGTGAAGAAAAGTTTACGC	TGTCTGCATCTGCCTCACCCTTAGATT
AAATAATACTGGTATGTATTTAACCATGCA	GGGAGAAATATCCAAAATAAGGACAGA
AGTTTATTTTGTTGACTTTTTGCAAATGT	CTATGTGATCAAGAAATCGATAGCATTTGC
GTTCTTCATCAGCTGTACTCCTAGAAT	CTTCCATTTTCTACTTTTTCTGAGGTTTC
TGGGAGGCTGTCAGTGGGGAACAAGAA	CCACACCCCATGCAAATATGTTTACTG
TGCACCAGTAATATGCATATTAAAACAAG	ACACTATCAAATACTCCACCAGTACCT
TCCTCCTTTTTCTTCAGCCACAGG	TTGTGTTTCCTTTCTGTGTATTCAACC
TGTGGGTTTTCATTTTAAATTTTCTTTCTC	TCAAGAGGGATAAAACACCATGAAAAT
TGCATATTTCAGATATTTCTTTCCTTAACT	GCCACAGAAAAAGATACTTTGTGATGT
GTGGCTTTTTGTTTGTTTGTTTTGTTT	GTCAAGAAGTCCAAGAGCATTGTTAGA
TCCTAAGTGCAAAAGATAACTTTATATCAC	ACTGTTGTGTTTTAGGAAAAAGTATTGC
CTCTGGAATCCAGTGTTTCTTTTAAATACC	TGGCTAAGTGAAGATGACAATCATGTTG
CCAAAATCTGTTTTCCAATAAATTCTCAGA	TGGTCAAGATCTTCACAAAAGGGTTTG
GCTTCTTTAGCCCAATGAGTTGAACAA	GAAACAACAGTGCCACTGGTCTATAAT
AATGTATATATGTTCTTAAATGGCTACGAC	CAAGATGATGTTTGAAACTATTCCAATGT
TAATCAGTGGAAAAATAGCCTCAATTCT	GAGCAAGCATTATGAAGAGTTTAGGTAAG
CATATCCTATTATGACTTGTCACAATGTC	AGTACATTACCTTATGCCTGAGAGGGA
AGGAAGGGGCTGAGGTCACTCA	ACTGCACTTCAAGTACCTATACAGCTG
ATGAAGGACTAAAATGTGCAGTACATGAG	TCTTCCGCTTATAAGTGTTGGGTGTTG
ACGTTGTGATCATTCAGTAAGAGCC	CACAGAAACAGCTCTAGACAACAAACC
AAAATAAGTAGGAAATAGCAGCCTCAC	CTAGACTCAACTTCAGTAGGAGGTACC
TGCAAAGAATGTGTTTTCAAGTGGCT	GGTCAATTATATGTAAAGTGGGGTGGG
GTTTCAAGCATAGTTTTGACAGATAACG	GGGATGTTATACATACACTTTTAGGGC
CACATCTATGAAGGTGTGTACTTTATTTA	CACTGGAGATTTTTATAGCTTTGACAC
TGTCAGCTTATTATATTCAATTTAAACCCA	ACACAGTCTGGATTATTACAGTGCACC
GGGTCCCCAGCAGAGCCCGCTGCTCA	ACATAGATCCCGGTGTTGAGCCCTCT
GAAGCTAAGGCAGCTGTTTCAGAGGA	CATCCAATTACACAGCTGCCTGCATA
CTCAATTTCATACCTTGCTTAATGGGTG	CAGATAATGGCTTCTCTGAAGACCGT
CTCTTTCAAGCTATGATTTAGGCATAGAG	AAAAATATCCCCCGGCTTGTGAGTG
TCACCTTGACAATAAAATTATCTATGCTT	AAAGGACAACCTTAAGCTGTAGCCATC
ACCAAAAGATGATGATAATTACTACAACAT	GCAGGTTAAAAATCTAGTGTATCCTCA
AAACTTATTGAACTTAGGAGGGGAAAA	TCTAACCAGCCTGAATATGATCACCTG
ATCTCCAAGTCCCCATCCATGGCCCAG	CGAGGAGCCCCTGCAGAAGCGG
TAATAGCTCTGAGGCGCCTGAGT	AGAAACTGTGTTCATATAAACCTTCATGC
AATAAAACATATGCGCAGGCTGCATCC	CCTCCTTGGGGGTGCAGCAGCCATTTT
CTAATAATGAGAGGAATGGAAAGATGCT	CCATCAGTTTGAAGCAACTCAAACAGC
CTCTAAGGAGCTTCATGACAGACTCAC	CTAGATGCTGGGGATATAACACACATCG
GCAAGATTGCCTCAAAGGAACAAATTC	ACCCAATTATGTCTCTATAACAAAGCTG
GGCTACACAGAATCCTAATAATCAGGC	ACAAAACAGGCATAGCCTAGTAACTGG
TTTTCCAAGAGAAGAAGCATATGGCTC	GTACATGTCTTTACCCAGTTCTCCAGA
CACAGAGCCCCTGGGGGTGGAACACTT	GTTCATGTGTTAAATATGATGGCCCACC
AGGGTGTGTAGGATGTGACACTCA	GCCACACTTCCAGGGCTGTGTAATAT
TCACTGCCTCCCAGCTCTGAAACATA	ACTACAGCCAAGTTCTCTTTCCCATTC
CACCTGAATACAGGTTATCAGTGCCT	CCTGTTTGTTCTAAGGCAGTAATTGGG
CAATCTTCCAGAAGTGACTTGTTGCTC	CTCATCACCGTATGCAAAAACTTGCAG
ATGCAATTGCATCAAAGCAACAAATAC	GAGTACATTCTTCCCTACTACCTGTGG
CCGGGGTCAGGTGGAGAGAGCGA	CAGGAGGGCTGGCCTCCTCCACCTTCT
CAGCCCTTGACCTTCTGTCACTG	TGTGCAGCAGCCCACTGACCCCG
TTCTAGTTGTAATAAATGATAGCACTCTCC	GTACATTCAGGAGGAAGTGCGCCT
GATTCTTGATAACACCATGCACAATATTTA	CCCAACATAGATGGACCAAATGCTAAATC
GCAGAAACATTTGGCACATTCCATTC	TGCTTTTACCTTTTTGTACTTGTGACA
TGGGGCCCAGGCCAGAAGGCGCCTCA	AAGGAGGCACTCGCCTCAAACACAAT
GCAGAGGTTCTAGACGCTGGAGCTGA	ACACGTCATAACTCTCTTCAAACTCCC
TAGGTGTAATTCCAGCTTCTCCTGGAG	TTGGTGAAAGCTCCTGGGCCTG
ACCTCTCCTGGGTGGGTGTGCTCCTA	AAAAGGGAGGCACTGTGACCCCAGTCT
GTCGCTACCTCAGTTTGCCCCCATGT	TGCTGGCCAGACCAGGCTGCCCGGAA
ATGGGTCCTGTTGGCCAGCAGGCTCA	ATGCTGTGGGGCGCAGCCCGTCTTC
AGCCAGATGCCAGCACAACCCGGGTA	CATGCGTCTACCAAATATGCCAGGTA
GCCATAGAGAGGCGGCCACCACT	CGCCTTATCCTCTAAATGGGGAGCATA
CAGATTGGTTCCAATTGGGTTTCTCAT	AGTAACTGCCATTGCTGTCACTGCCTC
TCTTCCACCAGCCCACGATGACAGCAT	CAGGATTGAGGCCACCCAGGCT
ATTCTTGACGCTGCCAACAAAGGCATGTG	TTCTTCCCTTGGCCTGTAACATTGCT
CAGCTGAGCCACAAAGCAAACTTTG	ATGGCCATGGGAAACATTGTATATTTAGTG
AAGGAAAGTGATGCACTGTGGCTCGCA	TCACTGAGCCCCTTCCCTGGCTCT
ATTCAGGTGTGGAACTGGGGGTCACATTT	TAACATCCGGATGCAACTGAGGCTGCTCCA
ACATACCATCTGTTGAGCCCCAGGTT	ATCAACGGAGACTCTGAAGCACTGA
GTAAGTGGTACTTGTGGGGATTCTGA	GCACATACTCGAGACACCCAGC
TCCTTTAGTTGTGAAGATCAGAAGGAAG	TTTTTGGCTCTGGGAATGTGGCT
TTTAAGGAAATTATTTGATTCTGTATGCCA	CACCACGGAGTCCTCCTGCCGGGGTT
AGTGGGAGCAACGGGGAGTTGGGAGG	TACACTTTCCAGGGGTGCTCGGGCCTCC
TTAGAGAAAGGAACTGGCCAAGCTCT	GCTCTCGTTTCTAACAGTTCTTTGCAT
GGAAAGCTGCCTACTACAGAGGGCTA	CACTTCCTGGGAAAGTGATGATGAGGA
TGTCAAATCCCCAGGCAATGCAGGAGG	TATCACTTTCCCTCATAGGAGGGCATGA
GAGGCTGACACTAGAGAAGCTGCAGT	GCTGGCCAGTACTGAGTACCAGCCAA
TCATCGGTGGCCCCGCCGCCACCTCCAC	TAAGTGGGCTGACCTTTAACCACCCAGG
GAATTACTGTCCTGTGACATAGCACG	AAGACCAGTGCCTGTTTCACAGCTAT
TCCAAGGGAAGACTGGGCTCCAAA	CTCTGGAGCCTTCTTCTCTCCCCT
GGGCAAGGCCAAGAAGTCGGTG	ATCTTCCGCCAGCTGCCAGAGAGC
AGGCACCGGAATCTCCTAGTCCT	CGCGGCTCAGCTGTTCCACCCGCTT
TGTACGAGCGCGTCGGGGCGCCGGCGCT	TGCAGCCCGGTCACCCCACGCCGCCGCCCA
CGGGGGCCGCGGCTCCGCCTCGTAGAA	CCTAGAGTCCGAGGCGGCCTCTGT
TCCTGCTTGATCACCAGCGGCC	GCCAGGAACTCGTCGTTGAAGG
GCACCCGGTACTCGTTGCTGTTCTTGT	TGCATGGTGGTCTGGCCGCAGT
TCTAACTCCCCCATGGAGTCGGCCGA	ACCTGTTCCAGCACAGCCGGCA
AGGCTACTGCCAAACCCCACAACTTA	CAGAAATCATTACACAGTGGTCACGAG
CACTTACTAGAAGAGGTTTATTTCTCCC	TGGAGATTGCAGTGACACTTGGGTCAT
TTAGCCTCCCCATCCTTGTAGAGGGGAA	CAAGCCACTTTTGATTTCAGCCTCCT
TTAGATTGTGCACCACACAGATTTATT	TGTCCCAGGAGAATCAGTGCGTATA
CAGGGCAGCCAGGAATCAAACA	AGATGCAGAGGCACGTGCCAAGTTG
AAGGATGCAAAATCTGTGGCCTCAGA	CAGACAGAATTCCTAGCCTGCCTCA
TCTCTTTTGTTCTCTCTTGGAACGCAG	CCACAGGCAAGAGCCCTGCCAATGGAT
TTTTGACCAGTGGAATGCTGTGCCTT	TGTCTTCTATTCCAATTCCTTTACCAG
CGGGGGCTGCAGGCGCAGCGGCATCCA	GTCCCGCATGGCGCTGTACTCCT
AGCAGCTGCCCTGTGGGGCCTGG	AATACGACCCCACTATAGAGGTGAG
GTACCTCTCATGCCCCTCATGC	GTCCACAAAATGGTTCTGGATCAGCT
TCTCAGCACCCCAGGAGAGGAGG	AGTACATGCGCACCGGGGAGGGC
TATCAGGCAAAGTCATAGAACCATTTTC	TGAGTGTTAGACTGGAAACTTTCCACT
ACAAGAAGCGGTGGAGGAGACCAA	AATGCCGTTTTCTTCTTGACTGTTTTA
AGTGAATCTGAGGCATAACTGCACC	GGAAAAGAGAAGCAAGAGGCAGTAAGG
CACGGGAAGACAGGGTCATCGGGAATA	GAGGCAGACAGGAAGAAAGAGAAAT
TTGGATATTTCTGCCCTGGGACAG	TCTTCTGGCTCTTTGAGAATGTGGTG
CAAACAGGCCCCTTGCAAAGCAGAAGT	GATCATCTCCCTCCTTGGGCCG
TGCTGGGCCTGGGGCGCGGTCTCGAGC	AAGAGGAAGCCCATCCGGGTGCTGTC
CTGGGGCCCAGCTAAGGAGACCACT	GCCCTGAAGACATGACCCCGCCA
TCCCCTTTGGGATAATATTTTAACAGCTG	CTTTGGAGGGTCCTAAGCAGTGA
CAGGTGAGGCTGTTGTGGCCTC	GTGCTTTTGCGTGGAGTGTGTG
CACAACCAAGGCTCAGCCAAGG	GGAAGGAGACCCAGTGAGCAGA
GCCATGGCCATCTACAAGCAGT	AGGAAATTTGCGTGTGGAGTATTTGG
ACATCTCATGGGGTTATAGGGAGGTCA	CACTCGGATAAGATGCTGAGGAGG
TCACAACCTCCGTCATGTGCTGT	AAAGAAACAAACATGCGTAAGCACCTC
CTGGTCAATATCACTAAGGACAAAAACAC	AATACAAAGCTTTCAAAGGATTCATGG
ATGTTTGTTCCCCTCCCCCATCAACTA	GGAAGATGAAACTGAGCTTCACCCTAC
TTAAACTGTTCACCTCACTGAAACCTT	CAGTATATGAATTACCCTTTCATTCAGCC
GAGTATTTGGTTTTCATGATGTTGCTT	GAAAATTATGGGTAATTTGGGAGCAGC
TAACCCCCTGAGCATTTTAAAAATTAC	CAATTGTCTCCATCACCATTTTTCTGT
CAGAAGATCAGTACCAAGGCAAAGTAG	AGGCTCCATGAGCCACATCCAAGA
GCGGAAAGGAGCAGTCAGGGCCCTTCA	TGCTGCGGTCCATGGGGATCACAGAATA
AAAAGCGTTAGCATGGGGACCCGAGGGA	TTGGAGAGCATGCTCAATCGCATCCT
TTTGAATCCAGCTAGTGAATTGGGTGA	ACCATAAGACATATCTCAACATTCAGTAC
CAAAACTTTTCAATAACCAATTTGTTTTCC	AGAAACCTTCACAAGGAATTTACATGT
TTCAAATTAAGAAAACGAGCAGTACAC	CGTATTTGAGCTTTATCATGCAATGCAC
CTCACGTCAAAGGTACCTACCTTTTGC	AGCTTCATTCAGTAAGAAATGACATTTGG
GCAAATCATTCGGTAAATCCAAACTGCTA	GGTGATCACAGGATAGGTATTTTTGCCA
CACTAATGCTCATGGCAAAGTGACC	TAACCATCATAACTGCAAAGAGACACAC
TAAAGTTAGGCAACAGGCAGCTG	ACCCTGAAGTATTGGGCAGCATTCTT
ATGACAACAGCAGTTCGAGAAATCAAG	GAGTCAACCTTTTCTAACCACCCAAAC
CAATCTTGAAGTGCTTTTAAAAAGCTAAC	CAAATACTCATACAATACAACACCCAAGTG
CATGGTTCTAACAGAATTTTAAAGTGTTT	CATTAAAACAGAGATTCTTCCTCCCTT
AATCAAAAGGTAATTGGTGGATTTACC	ACCTAAGTTACACAATATCATCCAGATTC
AAGGGTATCCGCCAACACAGAGGAA	GAAGTGATGTTAATCCTTATTCGAGAATTC
CTTTCATAATCAAGCACATATAAACTGTG	AGTTTGCTTCTACACCATCTGTCCCA
TAAAAACAAATCAAACAGTATTCGTGTAAC	TAGTATAGTAGTTGGCATATTCTGCATCC
GACTTTCATTATCAGAGTGTGATGATACCA	GAGTCTCATGAATCGTTTCAAGGTCTC
TCTCTGTAGCATTTCTTGAGACTTAAAGTG	ATAACACATGAATGTTCCTGAATACTAAAA
AATGTAATTTATAGCTCTTTTCATCTGCT	TCTCTGAGCCAGCAAAATCCAAGG
TGTCACTAGGGCTGCTTCTGTGTGGAG	CCTGGTATCTTCTGACAGCCCTTTAA
TTTTTCTTTTACATTTGCAGAGAGATAGG	TTGTTTCCCCTGTGATCTAAAGCCC
AGACCATTTCTCCTCATTTCTGGAGAC	CACATCCTCCCATGGAACAGATGAAA
TTTTTACAGACAGTGATGTGTGTTCTG	ATTTAAGCGCCTGATTCGAGATCCTG
ATTCATATGCAAGGCATAATGATATATAGG	TCTCAACTTCTTTCTGAAAATAAAAAGGA
ATGCCAGCATGGCACCCCTTGGCTT	GTATCTGTCTGCCTGTCCATGTACTTC
ATTATTTATCACTGTATCTGGTCCCCT	TACGAGGTCCTGCAGGTGAGTGTCCCT
GCTCCTCCTCAGCGGTTCCTCC	CAGAACAAGCCCATGATTGAATGGG
TAGTGAGGGTGGCACAGGCAAGAT	ATGGCTTTGCGGTACATGGGCT
GTTCTGTTAAGCTTATAAAGTTGAACTTTT	ATTTTTCTTTTGCTATCTGTGGATACG
CAAAGAACACACATTGCTGTGGTAAAAA	TCAGGTTTATCCACAAATCATTTACTTTA
CCACATAATGACAAATAAGTTTAGCACAG	GTAAGATCTCCATTGAAAATTTTAAAGCAG
TAATGTAATGGGAAAAGACTTTCCTGT	ATACGGTGTGCCTGGCATTTATGT
GTCAGCAAGAAATTGTGTAAATACTTCATT	GCAAAGTTTTAAGGCAATTTACTAGGGC
TTCTATAACATAACATTTAGAGTTGGGAGT	ACCCATTACTAGGTAAATTGCATTTTTC
TTGATGAGGGGATTGCTGTTTCGAGGT	ACAGCCATACAAACTATCTGGCTCCC
GTGGGGCAAAGCCCTAGTAACATAT	AGGGATACTCCTGAAGCAGAGGGAT
CAAGTAAAGTGCTTAACACAATATCTGT	CATCATCATCATCATCATAATTTGGGG
CTGATTCCTGCAGAAGAAGCAAAAGA	ATGAGGTGTCCACAGGGCTCAATCT
TTTAAGTATTTTCAGATGCATCTGTTACT	ACGAGCTGATGATACTCTCTTCATGATG
AACCACTGTTGTGACATTTTTATATAAGC	TGCACATCCTGTCTTACATCCTGG
ACCTGCAGCCTGCCCACTCTCCCCTA	CAGTACCAAAGAACTGCTGAAGATCTC
AGGCCTGCATCCGAGGAGCAGG	ACGTCCTGCGTGTCACACCACCT
GAGCTGGCGTCAGAGGAGGCCG	ACTTCTTTGTAGGGATTCTTCTCTTCTGG
TGAACTCAAAGTCCTGAGTTACCTTGG	TTTCCTCATTGTTCTTAAGAATGCAGA
CCAAGTAGATTCACAATATTCATGTGATT	GGCCGCATCTGACTTAATTAAGCCAT
ATCGTAGGAAAATGTCTCTGGACAACA	GACTGTCGCTGTAAAGATGCTCAAG
AAACATCTTCGAACGCATCCTGTTC	AGTAGCATTTAACAGGGGGCCGCA
GGAAAGAGGTCGACTCTGAGATTCTGT	TGTCCTCTGGCTCCTCTCCCTCCACT
TAGAAAGGGTTAGGAACTTGTCAGTATTC	AGAGCTGTGGGTCTAATGAAGCCA
GATCCTTCTAGGTGGGGACGGAT	TCTCAAAGGGTTATTTAGTATAAGACAGGC
ATTGTGTGCAGATAACTCCTGGGTAG	ACTCTCGGACCTTCCATGCCTTA
ACTGCTGCTGAGACGCAACAGGC	ATCAGGGCACGGAGGTTGGTGTTGAC
GTGATCTATTTTTCCCTTTCTCCCCAC	TTTAAGGAACTCCAGTGGCTTCCTTTG
