CCGTCCTGGGCCTGCTGCTGCTGA	CGTGCGCACCTACGGCTTCGCCACTT
ATTGGTCTCTCATGGCACTGTACTCT	AAAACCACAGGGAATGCAATGCTATTG
TGGTTCTGGATTAGCTGGATTGTCAG	CTTTCTATAATCAATGGAAATGAAAACCC
GGCAGTCTTTACTCACCTGTAGATGTC	TACAACGGCCATCACTAGGATTTT
CAATGCAGCGAACAATGTTCTGGTG	AAGGCATTCTGTAAACATGGGCAGCA
ATGACTTACTTGATCCCCATAAGCATG	TGTTTCAACTTGAACTCCTCAACCCTC
CAGATGGGAGGCTGAGGCAAACGTTCT	TGAACAAACCAGCACTATACCA
AAGAATGCTTACCCTTGGGTGCAGTT	TTGTACAGTTGTCAGGACCCTGAAATG
TACAGTTTATGAATTTGTCAATGTTACTGG	TTGCATCTTCATTATAAAATAGCAGAGTAT
TTCCATCTTGGAACTAGGGCAGGCA	TCATTGATAGTGTTTATGTATCTTACCC
TACGTGGACATTTCTTGACACAGAATG	CCTGCAACACAGCAAATATTACTTTCA
GAGAAATCACAGACATACAAAGCAGTC	AGAGATAGGACCATGATCAAAGTCTGC
AGGGTAGAACATTTTGAGAAATTAAAAAGA	GTTCTGGTCTACATAGACTCCACCATT
TATTTGCCATTTTGGATATATTCCTTACC	CAGGTAACGAAACTGATTAAGAGCCA
AGTCCGCGCGTCGTGCTGCCCGTAT	CCCTCTACCGCCCCGGGGTCCATTTT
AGATGCAGGGACACACGATGGGCTTCT	GACCACTTGAAAAATTAAGCCCAGTT
ATTTGGTTTTTGCCCTTCCAGTGTATAC	CTGACACAGGAGCGCATTGCACATCA
AGTGATAAGGTCTATGCCCACCAGAT	CAAGATGAGGAGATGCTTGAACTCCCA
TTTATAGCTGATTTGATGGAGTTGGAC	AATCCTGAGGAAGAGGATGTGGATACC
CAAGAAGCAGAAAGGGAAGAATTTTT	TAACCATAAAGCTTAACTGTTG
TAAAAATTCTTTGTGCAACCTACGTGA	TAGGAGAACATCCAAATCTCCGAATG
GGGAAGAAAAGTGTTTTGAAATGTGTT	TTTGGCCAGTACCTCATGGATTAGAAG
AACAGCTCAAAGCAATTTCTACACGAG	CTGATCTCAGCATGTTTTTACCATACC
TGTCGTGCATGTGGGATGTATTTGAAG	TTCACTGCAGTGGGGCAGAGTTGTTTA
GGTTTCAGGAGATGTGTTACAAGGCT	TTAGATAAAACTGAGCAAGAGGCTTTGG
CAGAGTGAGCTTTCATTTTCTCAGTTATCT	GCTAGGGTCTTTCGAATGTATGCAA
CCTGAGCGTCATCTGCCCCCACAGA	CAAGCACGTGGAGGTGAATGGCAGCAA
CAGTGTGTATGCAGGCATCCTCAGCTA	ACAGAAAGTAGATACCAGGTTCTG
AGATCGCAGACTTCGGGCTGGC	AGTGGATGGCGCCTGAGGCC
TGGGAGATCTTCACGCTGGGGG	TCAGGGGTGGGGGTCCCTCCGG
GACGACTCCGTGTTTGCCCACGA	AGATGGAGAGACAGCTACACAGAGCT
CCAGTTACCTGTCCTGGTCATTTATAG	CTAGTGCTTGGTAAGTTCCATGGGGTA
ACCTGGGGCCACATTTGAACATTGTA	AATAGAAGTCCCTTGAATGGAGCT
GTCCCCATAGGCCCCATTTACATCAT	ACGGAGGTGGGTGCAAAGAGAGATGT
TCCACCGTGATCTGGCTGCTCGCAA	GGCTCATCCTCCTTCACTTTAATCTCT
AAAATCAGACTTAATAGTCCGCGTGGG	GCAAATACACGTGCACCAACAAACAC
TTACAACGATGTGGGCAAGACTTCTG	TGGTAATACATGCATCACACCATA
TCCTGCCAAAGTTTGTGATTCCAC	TTTACAGGTAACCATTTATTTGTTCTCTC
CCTTCCACTGTACTTCATACATGGGT	CAATAATGCACATCATGCCAGCTACG
ATCTATTTTTCCCTTTCTCCCCACAGA	TATGAAACAGGGGCTTTCCATGTCAC
AGAACGGGAAGCCCTCATGTCTGAACT	ATTTTGGCAATGCTAGATTATAAA
GCTTTTAGGGCCCACCCTGGTCATTA	TCCTGGTAAGACTGATTTACATAAATAGT
AGTCATGACTTGTTTCATCTCTCCCAG	AGAGAGTATGTATATCATGCTAATGT
ACAAAGATTTGTGATTTTGGTCTAGCC	GTAAATCCTGTCTAGGGATATCACACA
TCGACTACCTGTGAAGTGGATGGCA	CTTGAAGTTTCATTGGTGTCCTGCTT
TTTTTCTGTTGTCGAAATGAAAATCAAATG	CAGTGTGGTCCCCGAGTCAGGCTGGAGAAT
TCAAACCAGACAAGCGGCTACCAGTCC	GCTCTCCTCCTGTTTAAAAGGAAG
ATTCCTGCTGTGTTGTCATAATGGAAT	CACAGAAGACTGTTGTTATGGC
AAAACGTGGGTCTCTGACTGGGCT	CTGACGAGGTGAGATGCTAAATAAGGA
TAGCCAGTACCTTCCTCTTCTTCTACA	CGGAATCGTGCCCCTTTGGTCTATAAA
TGAGAGCTCGATGCTCACTGTGTGTT	CCTAGTTTACAGACCACATGCATTTCC
CATTCTTCACAAGGGTATGGGTTTGTC	TAACTTCCAACGCAGCCTACCATGGTA
CTCACTCCCAGACTGGGTTTTTAGGT	ATTTAATGCTAAAAACAGGGACACCAG
GTCAATCCCCACATTTAGTTCAGTTCT	GCAAATAAGCCTATAACTTTGCACAGA
TTGTCTTTGAGTTCCATTCCACTTGTT	AGTATGGATACTCTTCCTATCAAT
TGCTCCACTAACAACCCTCCTGCCATCATA	AGGGAGAAACAGAAAAACAAAACAAAAC
CCATGACAAGATTTTCCCTTACCTTTT	TTGTGATGACCATACTCCACCTGTATG
AAGTGTTGTCATCAGAACCACTAACT	GAAAAATGAAGGCATAAACAGGAACAG
CCTCTTTAGGGAGCAATGAAATGAAGTC	TATTGTTTTAACAGATGTCCCAAA
GCAACAGAAAATCCAGGAACTTCTTCA	GAGAAATGCACTTAGAAGAAGCTCTG
ACGGGGAGCCAATGGTTCAGAAACAAA	ATGAAGAAGAAGAGAGACCAACAAATT
TCTGCTATTTGCAGGGTATTAGCAGAA	TCTTGGTTAATAGAAGAAACTTTGCAAG
TTTGTCATCAGCTGAAGATGAAATAGG	AGCACCCTAGAACCAAATCCAGCA
ACCACTTTTGGAGGGAGATTTCGCT	CTTCAGCTGACCTAGTTCCAATCTTTTC
GGTTCTAGTTTATCTTCAGAATCAGCCAGG	GATGTACTTCTGTCAGTTCACTTGATAG
ATCTGGAAGATCACTGGGGCTTATAAT	ATAGTGTTCAGGTGGACTTTTGGGTG
TGAACCATGCAGTGGAATGGTAAGTG	AAGCACCTACTGCTGAAAAGAGAGAG
GAACAAGAAAATCCATCTGGAGTACTTT	ATTTTTAGGTACTTCTCGCTTGGTTTG
AGATGCTGATACTTTATTACATTTTGCCAC	AATGACAATGGGAATGAAACAGAATCAGAG
GGCATGGCAGAAATAATACATTCTTCT	TCCTGAACTGGAGGCATTATTC
CCCTGTCGTCAACTCCTCAGCAGAACT	AGATTGGTATAGTCCTGAGGGTGGGA
GATGAGGTTCTGCTCAGAGCTCAAGTT	AGGTACATAGTCCCCACCACCCAAGA
GTGGTTCCTTAACCACATTTCTTTTT	TAATGCAGAGTGAGAACTTTCCCTAC
ATTCCTTTGGAAAACCTGCAGATCATC	TCATAAATGCAGACAGCAGTTCCG
TGAACCCCGAGGGCAAATACAGCTTT	CTTTGGGTGGATGTGTTTGCCTTGCTT
ACTGCGTCAAGACCTGCCCGGCA	TCAGAGATCAAAAATGTCTCCCAAGT
CAACCAAGCTCTCTTGAGGATCTTGA	CAGAGTCCTTGCAAGCTGTATATTTCC
AACGTCTTCCTTCTCTCTCTGTCATAGG	CTGAACCTCAGGCCCACCTTTT
TTGAAACTCAAGATCGCATTCATGCG	CCGCCTGCTGGGCATCTGCCTCACCT
TGATTACCTTTGCGATCTGCACACAC	ACACGTGGGGGTTGTCCACGCTG
GCAGCATGTCAAGATCACAGATTTTGG	TGTATTGTTTAACACATGCAGGGGAGG
ACTGCATATTCTCCCCACAGATAGAAG	CCATTGCATTCGATATCAGTGAGAAGG
CCTATCAAATATGTCAACGACTTCTTC	ATCAGTCTCAAAAAGAATATCCAG
TAGGCTTGTAAGTGCCCGAAGTGTAA	GACATTGTTGTTTATTTTTGGTTTTGCA
TCTTTTGCACAGGGCATTTTGGTTGTG	AAACGTTGATTTACACTTTCCC
TGCTGATTTTGGTCTTGCCAGAGACA	GTATTGGTTATCTCTGAGTTTCTCCTC
TTCAGGCCAGTGCGAAGTGCCCTT	CTCTGCACGCTCTTCACCCTGGTC
TGCGTCATCATCTTTGTCATCGTGTAC	ACTCCCCTTTGTCCTCACTGTGGCAA
AGAACTACCGATACCGTGCGGGCTT	GCTGCCCCCATGCTGAAACCCC
TGTTTGGAACTGGCATCGCCATGA	CCTCTAGCACAGCCTTGGTCAG
GGAGCCATACTGCCCCAGGATATTTCT	GAAGGAAAGGCCCCAGAGGATCTGAA
AGACAACTGTTCAAACTGATGGGACC	AGAGCAAGCATTATGAAGAGTTTAGGT
TACTTACCATGCCACTTTCCCTTGTAG	AGTCAAGCCAAACAGAAAAAGAAAACC
CCCTGCTTGCAGGATGGGCCGGTGA	TTCTGCTGAGCCCAAGCCTCTCAAAA
GAGGAGTCATCATCATCATCATCATCC	CCACTGCTCCCTTAGTGATGATCTCTT
CACAAGCATTTGGTTTTAAATTATGGAG	AACAGGAGTTAAGTATTTTTGAAACT
TGAGAGTGGCGGGGTCGGCGCAGTT	TCACCGCCAAGCAGACCCCCACAC
GTGGGAGATGGAACGCACGGACATCA	GCGTCTGCTGGCATTAGGCG
TTCCTGAAATAATTTCACCTTCGTTTT	ACCCCCAGGGTGACACAG
ACTCCCTCAGGTAGTCCAGGAGGTT	GTCTAAAGAAAAAGCCTTCTGAAGGATTCT
TCATCACTGAGTTCATGACCTACGG	GGCCAGGCAGCCTGCGCCATGGA
TTGATGACAGGGGACACCTACACA	TTTTTCTGCCTCTTTCTTGCTC
CTGCACACACTGCCGGTTGTCAATCT	AGCCTGGGGTGGTGGGAAGCCA
GTCACGCTTGAAGACCACGTTGGTGT	ACAGTCCAGCCCGTCCCACTCGCACT
ATTAAAGCTGGCTATGGCACCTGCAA	GGGAGGAAATTGCTGGGAGGCGAGT
AAGGTCATCTCAGCTGAGGAGATGGG	ATCTGTGGGTGGGGGTGGTGTGAGGCTT
CTGCATTTCAGAGAACGCCTCCC	GCTGGGGGCTCCATACAGCCCT
TTCATCGGGACTTGGCAGCCAGAAACAT	CTCCCAGGGATCCCAGGTGCACCAT
CTTTAGGGTCGGATTCCAGTTAAATGG	CCGTCTGTGCAGCTTGGCCAGGGAATT
CAGGCTCCCAGACATGACAGCCATCAT	GAGTAGACGGATGCGAAAATGTCCGTA
TGGATTCAAAGCATAAAAACCATTACAAG	CCTAAACCGATTAAGTCAAGAAGTCC
TGTCCACCAGGGAGTAACTATTCCCA	TGCAGTAAGTGCTTGAAATTCTCATCC
GCAGATACAGAATCCATATTTCGTGT	GTGAAGATATATTCCTCCAATTCAGGACCC
CTCCCAATGAAAGTAAAGTACAAACCTTT	TTTAGCTGGCAGACCACAAA
TTCATACCAGGACCAGAGGAAACCT	AAGCCAACCGATACTTTTCTCCAA
AATACATAAGTTAAAAACTTGTCAAGCAAG	GTCTTTATTTGCTTTGTCAAGATCATTTT
CACCATCCTGTGTGCAGGCTCCAAGAA	CTCTAACTCATGGGCAGCTACTGTTAG
ATACAGGCGATTAAGAAGACCCCTATG	ATAGCACAACCAAAGGAACCAAAAGG
AAAAGAGAATCATCCTCTCTCAACTCC	GTATTTACTGCCGTTCTTTTCCACGTG
AAATGCCTCCACAGTGGTCGGAGGAG	CTCAAGGTGAGGACTTTCTGAATCTAAA
CTGTAAACCTTGCAGACAAACTCTACG	AGCTGTGTTGTCCAGAGGGCTGTCAGT
GTACTGGTCCCGCATGGCGCTGTACT	GTTCACACAGCCAGCCTCTCCCTGGTA
GATCAGCTGGATGGTCAGCGCACTCTT	CCAGCCCCAGGCCCCACAGGGCAG
AAAATTTGATTGAATTGATGGCAGATATC	GACTCTGTACATGCAACTATTCCTTTC
TTCAGAAGTCACAGAATGATTTTGATC	GTCTACCCCCAAACCTATTACTAGCAA
TCTAAGTGAAGCTTTTTGTTTTTCTTTGT	ATGCTCTTTATCATTTTAAGCTATAGCTT
ATCAATGGAAGATGATACTAATGGAAATC	TCTTTTACTTCTTTATATTGATTTGG
CTATGAGGGTACCAGAGACAGTGGGAT	AACCTTTAAGTTTTAAGGCTATTTATTCGA
GGCTGTTGGAAGCTGCTTGGGAGAAGT	TAACACACTGGTAGAAGATTGGTGAGT
GCAGCTGTTACCTGTTTGAAAAACATT	TACCCAGCATATCTAAAACAGTTCTGT
CCCTTTTGAAGGCCTGGATGATAT	AGTCTGATATAATTCCTTGTTTAT
GCTTTCTGGCTGGATTTAAATTATCTAG	TTAATGTTGGCATTGTCTCAATAA
ATTATTCTATGCAAGATACACAGTAAAGG	ACATGATATGTGGGTATTCCGACTTTG
CTTAAGAATTTAGAAGATGTTGTTGTCCC	TTGGCAAATTTCATATGTTTCAACCTA
CATTTAAAGCAGAATTTCGCTTAGCAGG	TTCTTTCTGCTTTATTTGGGAT
CTGAAGGGCCGTGATGACCTGAGACAA	ATATAAAAGATGCCATTTGGTTGGGT
GCAGTCAGCAGAACTTGTACATATAGA	TGTTTTCAGCATAAACAGTTGTCC
GATGAGAAACTCTCAGGAAACTCTGTT	AGAAAGGAGGAGATTGTGCA
TGACCAGAGTTTCAACAAAGTAGCTGA	GATGGAAAGCTTGGGTGTGATCTTCA
TTTCAGTGTTACTTACCTGTCTTGTCT	ACTCTTTTAATTTGTTCTCTGGGAAA
GTACTGGTCCCTCATTGCACTGTACT	AAAAGGTGTTATATACAACTCAACAACAA
ATTCGTCCACAAAATGATTCTGAATTAGC	ATACACTATCAAATACTCCACC
GTCACCCACATCAAGATTCAGAACAC	GCAGATCCTACCTCTGAAAGGT
AACCATCCAGATGGTGCGGTCTCAGA	ATTCTCATTCTCTTGCTAGGCCTCTTG
AAGAAGGGGCGGAGGAACCGTTTCAA	TGCTGGTTTGGTCTGGGCTGCGGCAA
TGTCTACAACTGGTTTGCCAACCG	AGTAAGGTCCACGGTAAGTGGTATGT
AATAGCAGCCTCACATTGCCCCTGACAA	CACCAGAGTGTTATTTACTGTGATGTG
TTTTCGTGGAAGTGGGTTACCTGACA	AGGAGCATTAAAAATGTAAAACTCAAGT
CTTACCAAACTCTAAATTTTCTCTTGGAA	GTTAGGAATAGGCAGTTCTGCA
CCACCTTGGCTTCACAAAGTATTGGTAT	ATACCCATTACCATCTTGGACCTGG
ACGAAATAACACAAATTTTTAAGGTTACTG	TTTGCACTCTTCAGCAAATTGGAAAGG
GTGCTAAAAGTTTCTTGGATCACATTT	TCTCTGCTTGGCTTATTAACTGTTAGC
TTATTTAGTTTTGAAACACAGAGAACACC	TTTCAGATTTGTTCACGTTTCTTTATGT
CAACTTGACAAGAGAAATGATAAAACATT	ACATCTACCTCAAGAACATATAGGGAA
CATCATGTTTCATATAGGATTCACCTTTA	TGTTATGTTGACCATTCAAACTGCAAA
TATTCCCACAGTGTATCGGCTAGCCTA	GGACCAAGTAAGAAAATCAAGCACTTC
ACAAAACCATGTAATAAAATTCTGACTACT	TGCTGTTCAGGAGGTAGGTAATTTTCC
AGACATTCAAACGTGTTTTGATCAAAG	ATCTAATGTAATGGGTCCACCAAAACA
CACAGAGAAGTTGTTGAGGGGAGC	GAGCCACGCACACTCTACCCGTCAGA
TTTTTCCCTCGACACCCGATTCAAAG	ACAGTGGGGCACCACCACCGCC
AGCTGTGATCACAGTCACTGACACCAA	GAAAACTCTCTCCAGACTAGAGAATGT
AACGTCGTAATCACCACACTGAAAGTG	AAGGTTTGTATGGTACCTGGCAAGATG
GAGTTCCAAGGCCTCATTCAGCTCT	ACGGTACAAAAGCAACATGCATTTAGT
CGCTTCTTGTCCTGCTTGCTTACCT	TCCCAGTAGATTACCACTACTCAGGAT
TGACCTGGAGTCTTCCAGTGTGATGAT	CCTGTGGCAAGCAGGGGAGGCC
GTTATAGGGAGGTCAAATAAGCAGCAGG	TGTCGAAAAGTGTTTCTGTCATCCAAA
TCCCCAGGCCTCTGATTCCTCA	TGAGGTCTGGTTTGCAACTGGGGTC
CAAATTTCCTTCCACTCGGATAAGATGC	CTCATGGTGGGGGCAGCGCCTCACAA
AAGACCTGCCCTGTGCAGCTGTGG	ATGGTGAGCAGCTGGGGCTGGAGAGACG
GCCGGGCGGGGGTGTGGAATCAA	AGACGGCAGCAAAGAAACAAACATGC
AGACTTGGCTGTCCCAGAATGCAAGAA	CCTCTGGCATTCTGGGAGCTTCATCT
CTGAAAATGTTTCCTGACTCAGAGGGG	AGAAGGAACCCCCTCCCCCAACACCAT
TGTGAAAATTCCAGTGGCCATCAAAG	CTCTTCATTGGGGTTTGGGGAGATATG
GTACCCTTGTCCCCAGGAAGCATA	CTCCCAGGACCTGCTGAACTGG
CCAGGGGATGAGCTACCTGGAGGATGT	AGGTTAGGTGAAGGACCAAGGAGCAG
CTAAAACATGTTAAATATTGTCAGTATGCG	AGGATCTCAATAGTGTTTCAATTTTTGTA
GTGAAGGATGAATATGTGCATGACTTTG	TACCAGCACTGCCAACTTTCCCAACAT
GTGAAGGACTGTTGCAGATAGCATCA	CCATGTGGGCCTTAATTTTTAGAC
AGGGCCTGTTCACAATGAGCTTGCATT	GAGTACAATACTCATCATGACATGAGT
CTGAGTATTGGTGTTCCATTGCTTACT	AGAAGCCATTGAGAGAGCAAGGTA
TTTCTTCCTAAGGTTGCACATAGGCA	TGCTGTTCATAAGATCTACCCAAGTGC
TTCTTAAAAGGTCTTTGATTTGCGTCAG	GCTATCAGTAAGTATGCTTTTCATTCTTT
CTGCTGGAATTGGTGTTGATGACCTT	TCCTAGACGAAGTACTTCATACCATGC
CCGCATCGACTCCACCGAGGTCATCTA	CAAGATCCTCAAGAAGAAGAAGTTGCG
CACCACCGGTGGCACCCTCAAAATCT	GACCAGCCAGGGCTCCCCGGCTTT
CCAACCCTACATTTCTGCACAAAAGC	TAGATGTTGTCCCCTTCGAAGGGGTACA
GAGCCCAGACACCAAGGACCGGT	GGCTCTGCTGACTCGGCCAGGA
CAGGATCCAGGGCACTGATGGGCAT	TGAGGGAATGAAAGTGGGATCAGGGAT
GTACGACACTTGGCTCATCAAGCT	AGTCTGCCATTAGTGCACACAG
CTACTTCACGTCCACCGAGCCCCAGTA	ATTGCCAGGGGCGAGGCCCTTC
TCAATTTTGTTTCAGGACCTGCTTCGC	CCCAGTCCCTCTGGAATAACCAGCTGT
ATAGGTGGGAAACTACCTCCGTATGT	TGTAAACCTGTTTCAAAACCAC
TCCACAACCATCAACAGGAACCGCAT	CTGCTTTGACCTTGTGCTCCCCACAA
CTGGACATGGAGATCGATGGGCAGAA	AGATTCTGGACCTGACACGCAGGACAT
CCAGGCGGATGAGGCGTCTTGCCAACA	TCCTGAGGATCGGGTGGGGGTGGAGT
AGCACGTCCTGCTGGGTGGGCAG	AGGAGGGGGTGGACCGCGCACT
GACCGCATCGCCACCTTGGGCTA	GGCTCATTTGCCCGGTGTGCCG
ATGTCACGTTCTCAAAGCAGTGGATC	AGACTGACATCGGCTGGAGC
TGCCCGCGAGCCCCTCCCCATG	AACAGGGCTTTGCTCTCCTCC
GGGGGTCGAGCTGGGTGGGCCGT	GGCGCGGGAGTTCATCCTGAAGATGTT
AGGTTGTACTCCTTGAGGTTGAGCTG	CTGGGCGTCCCGCTGGGGAC
GCGGCCGTGAAGGACACCATCCT	CTCTGCCCGCGGGAGGAGATTTTT
GGAAATAGGTTTCATGGACTCAGTTAC	TAGAGGAGGGAAGACACAATGAGA
AAAAGTCCTAAAATCAAATTTCAAGAAAGC	CCACGAGAACTTGATCATATTCACTAAGC
AGAATGGTCGATGTAGGGGGCCAA	GACAGGCAATGGATTATCATTTTATTATCT
AGTGTATCCATTTTCTTCTCTCTGACC	GACGATGATCATCCAAGTCAATTCAAT
TCAACACGCAGGCTGCACAGGGCAA	AGTCGACTAGATGGGAATACATGATTTTC
CTCTCTTTAGAACAATTATCACATACCCCT	TCATACCACAGCTCAGTAGCTGTGAA
AACAGAATAACCGAGGAGTTCTGGAAC	ATAAGTCCAACCCATCTTTTGTATACGA
CGCTCACACAGAGTCCAGGACGGCAATAAA	CCTTCAGGTTCAACTGGAGGATGGT
CCTGAACCCAGACAGTGACAAAATTAT	TAGACACCCGCCCTGCCCTTCCCTG
GTCTGTGGCGCACGTGAAGTGGGAGTA	ATCTGCTAATGTATTCAATCATCATTGG
