CTTACCTAAACTCTTCATAATGCTTGCTC	AGAATTGAGGCTATTTTTCCACTGATTA
TCCCTCTCAGGCATAAGGTAATGTACT	GACATTGTGACAAGTCATAATAGGATATG
CATCACAAAGTATCTTTTTCTGTGGCT	GGAAAGAAATATCTGAAATATGCAGCA
GCTCTTGGACTTCTTGACTTAATCGGT	AAAACAAAACAAACAAACAAAAAGCCA
GCAATACTTTTTCCTAAAACACAACAG	AGTGATATAAAGTTATCTTTTGCACTTAGG
ACATGATTGTCATCTTCACTTAGCCAT	TTTAAAAGAAACACTGGATTCCAGAGA
TATCAAACCCTTTTGTGAAGATCTTGACC	TTTTTGATGTTTTTCCTTTCCTCTTCCTGG
GTTTCAAACATCATCTTGTGAAACAACAG	GGTCGTAGCCATTTAAGAACATATATACAT
AAGAATCATCTGGATTATAGACCAGTGGC	AGGAGACTATATTTCTGAAGCATTTGAAC
GCTGAGGGAACTCAAAGTACATGAACTT	CGAAATATGGATTCTGTATCTGCAATCTTG
CAATTCAGGACCCACACGACGGGAAGA	ATAATTTGTTTTCTATTAGATCTGCAGGTG
GCTATCGATTTCTTGATCACATAGACT	AACATTTGCAAAAAGTCAACAAAATAAAC
GAGGAAACCTCAGAAAAAGTAGAAAATGG	GGGGGTTGTTGACTTGTATGTATGTG
TTTTCATGGTGTTTTATCCCTCTTGAT	AGAGAAAGAAAATTTAAAATGAAAACCCAC
AGGAAACACAAAATATATGACCTAGCAA	TGTGGCTGAAGAAAAAGGAGGAGAGAG
CCGTCATAAAGTCAAACAATTGTAACTTGA	TGAGTGACCTCAGCCCCTTCCTGGCCC
GAGGCTGGGGCACAGCAGGCCAGTGT	GGGAGACCTGTGGCAAGCAGGGGA
CATCTTGATTTGAATTCCCGTTGTCCC	TTCTTGTTCCCCACTGACAGCCTCCC
TTTCCTATCCTAGTCCTGTCATGGGTA	AAAATTTAGAGACCATGAATCTTTCAAGT
CAAATTCCCCAAAACACAGTAACCCAA	AAAAACACGTTAACAGCTTATCCTTAAA
TGTCTCAGACAAAAGTCCATAGGACTG	CAGAACATAAAAGTTAGTTTCACTTTCTG
TGGTTTCCTTCACGACAGGTGTGA	CACCTTACATACACACCACCTAGATTTAA
TTGCTGCCAGAAATCTGCCATTTTC	TTTTTGTTTTTGAGACAAGTTCTTTTGCCC
CAGTTTGGTGTTCTAGTTCAGCACAAT	ACTTATCAAATTAAGTATTAGGGGACAGG
GACACAAGATAAGGAGAATGATTTGTAGTG	AAAAGATAAACATGGAACTTCATTTAAGC
CACCAAACGTAAAGCAGCAGTTTGG	TAAGCAAAGTATTTCAGGGAACCATTT
TGATGTAAGTACTTGCTTTACACAGTT	GCCTCTAAAACTCATACTATAAAGAATGCA
AAAGTGCTGCAATTGCCTGTGTC	CATTAAAGTTCTGACTCTTCGTTGATAAG
CCAAAGCAGCAGGAATAGGATAAAGAC	GAGAAAAACAAAGACCAATAGGAAGAAAA
GTCTTGGCGTTTCAGCTAAACCCAATT	AACAAAACAAAAACATGGTATCAGACA
GGAGGAAGGAGAAGCTGAAATAGAACC	GCAGTAACATAAAGTTCATTGTTACTAGCA
GTGCTTTGAGGCAGACTGAGTAAAAA	AGGGTTCCACAGAAACATGTACAGG
AGGAAGCCAGTCATGTTGATCCATTC	ACATTTCTTCCATGACAAAAGTACAAAAA
TCCCATGTGAGTGGAGGAGGATCCATA	GGGAAACGCAGATACACCTGTCAGCAAAT
CTGATGGTATTCTTCAATTTGTTAAATAGC	TTACGTTCACTGACTGGACCCATGGGTG
TAGAATTGAGTCCTGCTCTGTATCCAA	AAAATTGCAGAAAGAAGAGTCATCTCA
TTCAAACACAAAAGTTTGACATCTCAA	AGAATGGTGGAGAAAAGAGAAACAGC
GGGAATTCTGAGGAGGAACTGATGA	GCAACGTGTAGACTTCATTGGAATCTTTAA
CAGATGACTGAAAAGTTCTTCCATGCC	CTGAGTCAGTTTGGATGAATAATACATTG
TGAAATGAAAGCTATTTTGTGCCAGAA	CAGAACAGAGATGAGCACAAACAAGTC
AAAGCTGAAAATTTAGTTGGAAGGGGA	AAAACAAGGAGTTGAGAATTGAGTATAAG
GCAAAGTAAAAAGCACTATTCATGACC	AAAATGCAAAGTCATTAGAATTTTCAACA
GGCAAACTCTCCTTCTCAACCAAAAAG	AAAAATTAGCAGTTCACATTTAGCACT
GGGAAAAACCAAACTTGCCATCTCTCT	AAGAAAAATAACAGAGTAATTATGAGGCTT
CATAAAATAAAATTGATTAGTGGCATCTGT	TAGCAATCGCTTTAAAACAGACTTTCTCTC
AAGCCTTTTGCTACCTTTGAGGCCAGT	TTCATATGGCTTTGCATAATATGGCTT
TATATCTATAACTGTAACTCCTGGGTCAGG	AGTTTCTATTAAAGTAAGTTCCAGTCTGTG
AATTTCCGAAGCATAATAAATGTCATTTAG	CCATTTAAGGAAGAGTTCCCACCATTGTA
TGTCCAAGTAACTTCAGCAGAGCGAA	GCTGGGAACTGTCACAGCCCGACTCTAT
GGCTGTTTTAAAATTCATTAAATGGTCTCA	GGTCCGGATATGAATGATAGACTGGAC
AACTCTTTGTCGTTTGGCATCATCATT	CTATTACCTAGAATCAGGCCTGGAGAAA
GTCAAATCTAGTTCGTTTTTGCAAGCA	TGGTGCCACATTGGGCAAAGCACT
GAAAGTAACATTCAACACTGATACCCA	AAAACATTAACTCCTAAACTGAATCTCG
GCAACAAGAAAAGATGGAAGAGTACTA	GGCAAAGAAGATATGTTTGAGGCTAGTA
GTAAGACATAAGGGCTAACTTACTTCA	TTAAAGATAATCATGAGATGGTTGATGAG
GGTATTTGTACTTTTTGGGTGATCCTT	TTTGAACAAGCATCTGCTGAGGT
GCTGCTTGCCTCCATTAGTTGGAAAAT	AAAAATTTAACAAATCACAAGTGTGACTT
AGTGCAATTTTAAAATTAATTGATTGCTGT	CAGTCCCCGAGCCAGGAAATCCATGA
CAAAAACTTTGCTACACTGACATGGAAAA	TCTGGCCGACAGTTGGATAGGTGGC
TCTAAGAAATGGCTGGAAAATAAACATG	AAACAAAAGTTAAGAATATGCAAGTTCATT
CTGTAGTCAGTGCATTCTACAACAGC	ACAGAGGAACATTTTAGAGGAAAATTAAAT
AACACCATGCTGCCTCCTGGAAAAA	TCAAATTTTACTCTTATAACAAGCAAGGTA
AAGTCCAAACAAAATTAATATTTTTGGCT	CCTCCTGCACTGCAGAGCCAGCTTAGTAT
TCATAAGAAAAAGGAGCAAAATTTGCTATA	TAAGGAGATGTGGGAGTCAGGAGGGAT
AGTACCAAGACCTTATAAAGTGGTGGC	AAAAAGCAAGTAAGTGATGTTCATAAGAT
GGTCACTAGTGAAGAGCCCATGTTAAG	CAGCCAGTTACTTCTTCTTTTCCTTCCA
CACACACCAAAGGAACATCATGAATGT	AAATCGAGAGAGATTAGAAGGAGGAA
GATACAGAAAAAGTACAGAAGAAGCTG	TAAATAAATAAGCTTTACTGAAGCACTGA
GAGACAATAAAGAGGGTGTTGTTGGC	GTGATTCTGTTACAAAGTATGATCAACTA
TTACTAGAGACATCAGGTTTATGTATCCC	CCTTTCATTTCAGAATTTTCCAGTGAAGAC
ACCATAAAACCTTTGGAAGTGTAAGTT	AAAAGAGAAAGACAAAGAGAAGACTCA
GAACACTGGGAGCCTGCACTCCACAGA	ACAGAGTAGGTGAGGGGAGGTAGGA
TTTACATTTTGTTGTGTACCAGTTACAA	AAAAGGATCTCACCAGAAGAGAGAACC
TGAGTACTCTCAGTTGTATTCAGCAGG	CTGCTTAATCTAGAATGTAAAAGTTGCC
CGCCCGGCTGGTTCTAATATTTATAGA	GACAAGGGAGAATTAGTAATGAAGGTAA
CAGCTTCTTGGTTCTTAAAAAGCAGC	GTCTGTACAAAGTCTTTGCCTTTTTCCT
GGTTCTTCCTGTGTCAGCTCAATAGCT	TGAGGATGCTGATACAGTTTGAATATTTG
GTGATTGCTCAGCAGCATTAAGTACAG	TTGCCGCTGTTGTCTCAGAGGAAAATG
TCAGCCACTGTGTATTTTCATATTTAAAAT	AATTTTCATTCCAGATTTAGCAAAAACC
TACTGTTCAAAACTGTATGACCTATGT	GTAAGCAAATCTATCCATTAAGTCATTTGA
CCTTTGGAAGATAGAAATCAGTGGTGA	TGTTCTGTTGGAATAGTTCCTTGATGA
ATCTGGCACCGCCCACCAAGAAATTGA	TGCAACTGTATGGCACATTTTCTTTTT
TCTACTCCTCCTGTCTCTTTCCACATC	TCCTGAGAGGCCAGCATGGAACACACA
CTCCTCCCCATTTGTGGGATATATGTT	AGCATATGAACCTTTAGATTTATACAGCA
CATAATTTTGTTTTTCCATTGATTGGCT	GCATTTCATGTTCAGTGATTCTGGGGAT
AACCTCCTATTAGAGTCTGAACAGAGC	GATATATATGAGTGAATTGTGATCAGTTGG
ATGGTTAATTTTCTCATTCAGATTGCTGG	ATTCTAATTATGTCACATTTGCTTACTGA
GAGAGAATTGGGATTTGTTTTTCTTATACA	TGTTATATTGTGTTGCTAATAGCAATTTCA
TGCATATGTTATCAACCTTTCTATGAGA	AAAAATTGTTGACTTGGTCTGCAATAA
CAGAGAAATGTATGTGATTATAAGGCAAC	TGTTAAACTTGTTTGGTTTTTGTTGTTG
CTTAGGTTTTCTTCTGTTTTCATAGCCAG	CACTTTGTTGATTGTTTATTGATATGTGAA
GAACAAAATGTGCGTAGAACATTGTTCTG	AAAATAGACCCCAAAATACTAAGAGCTG
GGTGCACTGTAATAATCCAGACTGTGT	TGGGTTTAAATTGAATATAATAAGCTGACA
AGGTACTGGTGGAGTATTTGATAGTGT	CTTGTTTTAATATGCATATTACTGGTGCA
GCATTTTGGACAACACATTCTTGGCAA	GAAATGTGGTTAAGGAACCACAACACTT
GTAGAGGACTTGCCACAAAACAAACAT	TGTAGCAGCCAGGACTTTATAAAGCTT
GCACATGGCAGATCTCAATACGTGTTT	AGTTCAAGTCAGACTGTAATTTGGTTG
AGATGATGCATTTCATCTTAATACAAAAGA	TAAGTTGGGCAGCTGCTGGCCTCCCTTGG
GGCAAAAGTGAAGACTGGCTCTATTTT	ATTTTAACTTGTATCCCTTAAAGTCTGC
ATGGACAAATGGATGGTGTGCTTTTAA	TCTAAGTAGTAGCACTTTAAAATGGAAATG
GCCCTCCTAAGAGTATGTTGTCTGCTA	AGGCTGGGTCAGGGTTTCGTAATTA
GCCTGGCTTCTCTCATAATTTTGAATT	AACCCACTTCCACGAAAATCACCTCA
CTTTAGCAAGTGAGGAGCATTTCAAGG	AAGTTAAATTGCCGAGAATTTGATTTTTAT
TCTTCTCAATACGTTTCCCTATGAATATTA	GAGACCACAAAGGACTCTAAGATACCAT
CCATTTGACCCTTAAAACTGGCTCTAG	CACTATAATATCATGCACTTTCATTTTCAG
CTTTTCTGAGGGGCTGCTAAGAGAATT	GACACATCCATGGTAGCTGCTATTCT
GCTGGAGTACCAAACTGCCTTTTTAGT	AGCCTGCTACTAGTATTCCAGCCTGG
AAAAGGTTTACAATAAACATGAACAGAAAC	ATCCACTTCCACAGCGGCAGCTTCGTA
TGTTGCGTGCAGTGTGTCAGCATGCAT	TATCTGCTTCCATCACACTGCAAGTGCTG
TGCATGTTTTCTTTTTAAGGTGTGCAT	TTATACCTTTAGCTGTTTTTCTCTAGAGA
GTAATATGGGCGCATAACATGTGCAT	CAATTTAGTTTTAAGGACTTCATCCCTCC
TCTGGGGAGAGGGTTCCTCCCCC	TAAGGCCCCGCTCGCTCGCTCGCAGCCCC
CCTCCTACTGAAGTTGAGTCTAGAAGA	TTCCTACTTATTTTTATACGGCTATTTTGT
GTCTGAAAGCATGAAGCCATTTCCTAA	AAAAAGAAGGATGGTGAAACGCTTA
GGAAGGTCACACTAGGGTTTTCATTTC	TGAGGCCCAGTGGTAGCCCGCTGACC
CTGTGTATTTGCCATCAATAATAGCAAGT	AGGGTAATTACTGAAAGTTAATACTGGAAT
ATCCTTTCAGAGAAAATAATGCTCCTAG	AGAATCCTGGGGGTGTGGAGGGTAA
TGTAGGGTGATATTGGATACTTTTTGTTT	ACAGAAAACAAGTGGTTATAGATGGTG
GGAGGAGGAAGCCTCGGGTCCC	TAAGTGTGGCCCCATCCCGGGAACAGGCT
CCCGCATTCCAACGTCTCCGAC	CACATGTTTTTATACAAAATAAGAACGAGG
GGGCGATCTGGGACTGCATGCT	ACTGGGCTGCGGTCACGGGTGGGA
TGAGCTCAGCAGCCAGCGGCCACCTG	TACTCCTCGCCTGTGGACAACACCCCCA
CCAGTGGCTGCACGTCTGCCTG	GGTGAGGCTGGGTGGCCAGCCG
ATACAACCCTCTGCGGGGGAGTGTGGCACC	AACTTACAGATGCAGCAGCAGAACCTG
CGGGCCTACCATGCCATGCTGCA	GCCAGAGGCCACAGGCAGGTGGGAGAGA
TTCCAGCAGTCTCCGTCCGTGCCCCTC	AGGGGCCCTGAATTTCACTGTGG
CAGGTGCCCGATGCCCAGGTGGGTGT	CCGTGCCTTGAGGTCCTTGGCCTCCTT
AGCCCGCAGCTGCACGGAGCCCCGC	CTGCTGGACAGCTCCGGCATGC
GCCCAGGTAGCCGTTGGGCGAGCAGA	CACCTTGGCGGTCTCGTAGCTG
ACCTGACGCCCTGCTGGGCCAGGTGA	CTCTCCCCACTTTATGGTAAAAGAGACG
AGCTCCCTCCGCCGCCGCCCACCCT	AGCACGCGGCTGAGCTCCCGCAGGAAGT
CACTCGCACTCCGCGCTGTTGCA	ACTGCATGCTGGCCTCCGGGCCCAA
ACTAGCTGCTGGACCAGGGAGGTGTG	AGAGAGGCTCTGAGAAACCTCGGGAA
TGAGGAGCTGGGCCATCGCGATGTC	GGTCTTGCCTCAGCTCACGCGC
GGGCATGGTTACTGCCTCTGGT	CAGCAGCAGCTCCGCCACTCGG
CAAGAAGGAAATTGGAAACTGGAAGCAA	TCCACGGCGCGGAGCCCAACTGCGCCG
AAAAAGGGGAGGCTTCCTGGGGAGTTTTC	ACGAACGTTTGGGATAAAAAGGGAG
AGAGGGTGGGGCGGACCGCGTGCGCTCGG	AATAGTTACGGTCGGAGGCCGATCCAGGT
TGGCATGAGTCTTTGATCTGGGTAACC	GAAACCCACAGAAACACACACACATA
GATGAGAATCACAATCACTGCAGCCT	CATGTTTAGATCACAATTAGGGCAACATT
GTGCGGGAGCGAGCTGGCCACACCTGT	GCGGCCACTGATAGGAAAGCCCAATCTTT
TGTCATATTGTTCACTTCATCTAAGCTA	ATCAAAAGACCAAATTCATTGCTATGG
TGTTTCAAAAATATTTTTGGACATAGGTC	TCTAAGTCCATTTTCTCTATGTAAAAGAGA
TAGCAGTGTGAGAACAGACTCAACAG	GTGTGTGTGAATGCGAAAGTAGTTAGT
CATCCACGTCAGAGACTTTGTATAAAGG	TGGCCTAGTTGATCCAGATCAGTGA
GAGAAGACAATCGAGAATTTGGAGGAA	GAAACTAGAAGCCAAGAAAGCTGCAG
GGGCAAAACCAAAATAATTTTCATTTTTAA	TTTGTCGGCAAGTCTTGACTGGCTCTG
AGTCATGCAGCAGTCCCAGCAG	ATATCTATGGAAGCACCAGCCCTATG
GCAGTTGTCCACTGATAGGTTTCCATT	TAACTGGATTGGGCCGTCTCATGTATGG
TGAACCCTTACCCTGGGCTTTTGAAT	CAAGGTTTGGAAATAGCCAGAGTTTTAC
TAGAGGTGGCTCCCATGAAGTGGCCATC	ACTGAGCTTAGACAGAGGGTCTTGGC
ACCATTAGACCAAATGTACATCATGTAGGG	TGCCCTGCATCTCCAAAACAAGGAGAA
ACTAGTGCCAATGGCTGCTTTTC	GCACTGTAGTTATGGATTATGTGAGAAGGT
AGAACTGCTTGTGTCCAAGGAGGCTTA	GTGCAAAGCGTGAGCTGCATGCCACAA
TTTCACACTCTTCCTCTTTCTCACGGGCT	TTGGAGCCACGGCCACTCCCCCAATGTC
CATGAATGAGCCAAAACATGGCTTGG	CGAAAGGACCATGTCCGTGACCACAGA
ATGAATACTGTGACCTTTCCCCACTGCC	CAAGAGACTTGATGAAACGCAGGTAAG
AACAATCTAATCCATGTGTCCTAAGCA	TATTGGCTGCTGCTGAGCCCATCTCCTG
GAATGGACTTAGTCTGTTGCCCTCA	ATATCGGAATACCTAGACATAGCAAAC
TTGTGGATGGCCCCGAAGCAAG	CAAAAGTTATTATGGAATACCCTGTATGAA
GTTTCAATTTCTTGATCTGAAGGAGCCC	TTCTGGATGAGCTCTCTCAGGCAGTGG
AAGTGTTTGCAAAATGGAGGAATAAAACG	TCTGTAGCCCAAGAAAATGCAGTTAAAG
CACCATTAGGCATTAGCACTGCCTT	CAAATCGGAGACATTTGGTTGACTGC
AGCAGGAGGGGAAAAGTGCTAATTAC	ATGCCATTAACAGTCAGGCTACTAATG
ACTGGCATTATCAGCATCATCAGCA	TGGAAACACAATCTGGATAATATTGAGA
AGACCTCTAACTCTGAGCTGCCTCCAAA	AAGCTAGCGTCTGGTGAAGAATTCTG
ATGGTGGTGGTGGTGTGGTAGTGGCA	GGAGATGGGCATATCTCAAAAACTGATTTT
GAAATGAATGGTGCTTACTTCAAGCAA	AAAGTAACACAACACTTTTAAGGGAAGTG
CATTGTCCCTGCAGTCTGTATGTCAT	CTCCACCATTCAGAGTGCTTTTTCCT
ATGCAGCCCTTCTCCGATGCTTTCTGAAA	CAAAGAGCAAGAGATTCTGAAGGGTCG
ACTGAAGAATTGATGGCAGTGATGCC	AGCTCTCCACTGCTACCAAAAATTGG
ATTGAATTGAAGGCCCCTCGTTTTCAC	TCACAAATGTACCAAGTTGAAATGAATC
GAATCTGCTCTTTGTTGAAAATGAAATCTA	TGTAAGCTTGCCTTGGGAGCCCC
CACTTCTCCAAAACAGACCATTTACCA	GCAGCACAAACACAACCATCCCAGAGTT
CTTCCACTTTAGTCTGGCCAAAGAATG	GTGAGTTTGAAAATGGCTCAGTCTCTG
TACTCCAGACTTTTCCTCACCCCCAAA	CCATGAAATCAAGTGCATGCAAAATAC
GAAGATCTTGCTTTGGGATCACATTATTT	ATATTCTGTACTTCCTCCAGTCCCA
ATCCTGAACTTTTTGCAGGAAACAAGAC	TCAGCAAAGGTACTTGATACATAACCATG
AGTTTGGGGTTGCTGTGTTTGCTG	TCTTGGTTTCTATTTTTATATCCCTGTAGA
AGGACACTCAAAAGCATGCTGCTCTA	AGAATCCACCTGCAAGCTGTGATAATG
TCAAAACTGTGACTGGCCCTGACATT	TTTTCTGGTGGTGCTGTGTGCATACAGGC
AGTCGTTATTTGACCATAAGGCTCTTAC	TTTTATAGAGTCACCTTCCAAATTACTAGA
AAAATCCCATATCTGAAGATAAATTTGCTA	GGTTGGTGTCTTTTCTGAAGAAGTTGTTT
TGAGACACATGGCGTTTATCCAGAA	AAATAATCGTGCATGTTTATTTTTCCCTC
CTGCTTTGTGTGTGAAGGCTGGAAAAA	ATACTAAATATAAAGGCTACATCCACAAAG
TGCTGCTGAGGTGGCAGTTTCCT	GCTCCTTACACTCTAACACGCCCACTATA
GTCAATAATGCTAGTCATTTCAATTCTCAC	ATTTCAGCGAGTTTGCCCTCGACTCTGAC
TTCCACAGGAAAAGTTCTGGAGGAGT	CATGAAATTGATAACCGCGAAAATAATTGG
AGCGTAGAGGGAAATGGCATATACGTG	GATTTGTTTTAAACGGGCTGAATAACAA
GTCTTTCTGTGATTGACTTCAATTGCTG	CCCTGCATTTTATCAAAGGAGCAGG
AACAAATTTATTAAGTGGAATTGGAAGGA	AGGCAAGCTTGGCCTTCTTTGGT
AGGGGTTCCGGCCCCCGACGTGCT	TTTTCTTTCTTCCCTCTTCTCTTCTCTTC
GATTTCTATCTCCTGCAACCACCACTA	AAAAAGAAAAAGGAAGAGAAAATTGGGA
GTGATGTAGTTGCTTGGGACCCA	AAATACCAATTTCATTTTAACAAGTCCAC
CTTAGGCTATAATCACAATGGGGAATGG	GCCAGAGGTCCATCTCGCTGAGATA
CCCACCTGAAAGATTCTTTAAACATCTTC	AGGACTGCTCTCACTCTCACGCA
TGGATAATGGAGCGTGGTGATGAGC	ATCTCACATAAGGAGCTCTCCACACA
AGCCGCTTCAACACCCTGGCCGAGTT	GAGGGCGTGTGGAAGAAATACAG
GATATAAGACGGAAAAGTCAATTCCGT	TACACCTCCCCGTACTGGCCCCCGCCCAG
TCGGCAGAGCACAAATATTCCAACGA	AAAACGAAGGTGAAATTATTTCAGGAA
TGTGACTCCATGGCGCAGGCTGCCTGG	CAACAAGACAACGAGGACTTCAACAC
AAAAACCCTCCTGTAGTCAGGAAGGA	AGAAAGGAAAATGTTCACCCATGAGAG
GTACACACTCCTGCACAGTTGAATTTC	AAGAGAAAGGCTGTTCAAGATGTGTAG
AGAAAGCACAATACTCCACACCTCTG	GGACAGATGAAACCCAAGTCAGATCA
TATGATGGCCTGAATGTAGCCTCTGG	AGAATCATACAGGGACAGAAACAAAAA
TTCCGGGAGATGGACGGCCAGC	AAGTCCAGCACGCTGACCAGCA
TCTTCCCGTGGACTGCAAGTCCCGAGG	TGAGCCCCCGGACTCCCGGAGGGCTCC
GCCTCCTGCGTTCCCCATGGGGCCAA	GCTGGTGAAAAAGAATGAGGAAGCTG
TAAGGCACTGCCCTTTCCAGCTTCTTCC	TCACCTGGTCAGACCTGTTCTCCCCT
AACCCCTCCGGCGGCAGGTCAC	GAGTCGCCAGGGAGGGACAAGGGGAAATT
AGCATCAACCAGACTCGTGGCTTT	TCTGGACTCCTCGGCGGGGCCCTTGCTG
AGATGGCGAGGCACAGCGCCTCGGTGCT	TGATGGGGGTCCCCGACGGCTTGGCGG
CCAGAGCGGATCGCCAGCGGCGCCATCA	GGCCATCAACAAACTGGAGAATAATCTC
TATGGGCGAGCCCGCATGTGCTGCAG	CTCGGAAGGCAAACTTGTTCCTCATTT
CACTACCAGACACAGAAGCACAAATAC	GAAATATAAACGTCCTAATTTCAGTGTGC
CGACAGCTCTCCTAGTATCGCACTATT	GCGTTCCAAGAGAGAACAAAAGAGAG
TGGAATAGAAGACATCATCTTCTCACT	AAGGCACAGCATTCCACTGGTCAAAAG
GATAAATGACCCAAGTGTCACTGCAAT	AGGGAGAAATAAACCTCTTCTAGTAAGT
GTGTCACCTGACTGCATATGAGAAATG	AACCACAAAAGAATGGATGAGGGTTAT
TATACGCACTGATTCTCCTGGGACACAC	CAAAATAAATCTGTGTGGTGCACAATCTA
AGTCATTGCAGCAGAACGTGGG	GCTAAGGATGCAAAATCTGTGGCCT
TCAGCCTGGATCCGAGAAGCCACAG	TGTACAGATTCCTTCTGGCTCTGGTTC
GGCACATCCTCTGCAGCACCCGA	CTTTCCCGAAAAGAAGCCCCGGCTTGAA
CCAGAGTTAAGGGCTCTATAATCTCATGA	ATGCAGAGGCCGCCTGCTCAAAGGATT
GAGGTCCCGCGTGGAGCTGCCG	GGCCATCTTCCTTTAAGAACGGGACA
AACCCCGGCAGGAGGACTCCGTGGTGG	TGGCATACAGAATCAAATAATTTCCTTAA
TTTCTCAGAGAAGGCAGGTCCTCTCTCC	CTCATCGGTGGCCCCGCCGCCA
CCGCCTTATCCTCTAAATGGGGAGCATA	CTACTGTCCTCCCAAACCTCAGTAGCT
TCATCTCCCACTAGAGACAGAATGGGA	AGTGGGAGCAACGGGGAGTTGGGAG
ACTTCCTGGGAAAGTGATGATGAGGA	AGCATTTGATGACGAATTAGGGCTTGG
TCTGGATTCTGGTTTGGGCTGTTTC	ATTCAGGTGTGGAACTGGGGGTCACATT
CTCTCGTTTCTAACAGTTCTTTGCATTGG	GCCTTACTTCACTCTGGACTGTGCCAT
TCCGTGAGGTGACCTTCAAAGTCAG	TCAAATCCCCAGGCAATGCAGGAGGG
AATCAACGGAGACTCTGAAGCACTGA	GCGTCTGGTTACAAGGACAGATGGGAT
AAGTGGGTTAGTGGCCTCCACTGAGGAC	CAGATTGGTTCCAATTGGGTTTCTCATC
CTACTGCTGGCCAGTACTGAGTACCA	GCTACGCATGGGATCTTTACATGGT
ATTCTTTTGGGGTGCTCCAGGAGCCTGGGT	TACTTGTGGGGATTCTGACATGCTGTC
GGAGCCTCTTCTGCCAGATAGCTGTGAAA	AAGATCAGAAGGAAGTCCGTGCTATG
CCTGTAACATTGCTCTGATCACCCA	GCTCTTTGGAATCCATTTCTTCCAGTTTC
TCGTTTCTCATCTCCAAATGTGATCTCC	GACCAAGCACAAACTCCATGTCTGGT
AGTTCCAGGGGACTATGCCCAGTAGCT	ATCTCAGCAGGAAGAGGCATCGGGTCCGC
GGGGTCCTCTTAAGGCAAATGCCGAGAA	ATGGGAAGCTTTCTAAACTCCAACTGAG
ACACTGGAGCGAGATGCTTTCCACC	GGGAGAGAAGAAGGCTCCAGAGG
GCAAATGTTCACTGACAGCAGCA	ATACTCTTTAGGCAGGAGCACTCTTG
GATGCCTATGGATGTAAAAGGCCAATG	AAGATGAAGAAATATAATTCAGTTCACACA
CAGTGTCAAGAGACACTTATGCTATCC	TGAACGAGACGGCTTCAAACACTCAA
TGTCTGCACTGCTGTTGGACCACTTT	CACACCCACTTGATACTCCAGATTTTG
ACAGAATATACCATTAACAGGCATATTTG	AATTTAAAAATTAGCTGGGGTGATGGT
AAGCGGGTGGAACAGCTGAGCCGCG	AGGACTAGGAGATTCCGGTGCCT
ACCAAGGAGCTCTCTGGCAGCT	CTCGTTGCTGTTCTTGTCCACCGACTT
GCACTGCGGCCAGACCACCATG	AACATCGCGGTGCGCAAGAGCCGCGACA
CGGCGGCGTGGGGTGACCGGGCTGCAGGT	GATCACCAGCGGCCGCAGCGCC
ACTTTGACTACCCGGGCGCGCCC	AAGCAGCTGGCGCTGGCCGGCCTCTTCC
CGTGCGCTCCCCCGGGCATGAC	TCGCAGATGCCGCCCAGCGGCT
AGGCTCGCCATGCCGGGAGAACTC	CACGAGACGTCCATCGACATCAG
TGGCATATTTGGTAGACGCATGACC	TACCCGGGTTGTGCTGGCATCTGGC
GTTTGCGGGGAGTTTGAAGAGAGTTAT	TCCAGCGTCTAGAACCTCTGCTGG
TGCCAGGGAGATGGCTCCAAGTA	TATGTCCATGCTGTGGGGCGCAGCCCGTC
TTTTCTGGCTGCCGCTCTGGCACACCCCT	TAGGAGCACACCCACCCAGGAGAGGTG
CCACTGTGTAATGATTTCTGCTCCTTG	TAAGTTGTGGGGTTTGGCAGTAGCCTGGG
ACTGACCCCGCATCCCCCACTGTGG	TCGCTCTCTCCACCTGACCCCGGG
TCGGACCCCACGGGCTCAGGCGTGGTA	TCTCCAGGAATTAGCAAGGCCACCTGA
CCCCTCTAAATCTGGTATGGTGGAAAT	AAAGGATGGAGGCTGTGCAATGGGAGA
AAGTGTGGCTCGTGGGACAGGAGGAG	AGTGTCACATCCTACACACCCTCCTGT
TTGGTGGGTCCGTCAGTGCCCACCCTA	TGAGGCGCCTTCTGGCCTGGGCCCCAG
GGTGGGCCATCATATTTAACACATGAA	AAGTGTTCCACCCCCAGGGGCTCTGT
ACGTGACCTGGAGTCCTAGACAAAGA	TAGGTTCCTGGACGGAGCCCCGGGGAGAC
AGAGGGCTCAACACCGGGATCTATGTT	TGAGCAGCGGGCTCTGCTGGGGACCCT
TTCCGGGCAGCCTGGTCTGGCCAGCAC	ACATGGGGGCAAACTGAGGTAGCGACA
CCCAGAAGAGGCTGCCCCTGGTGCTGA	CAAGTCCCCATTGGGTAATAGCTCTGA
GCATAACATTCTCTAGAATTTCAGAGCGGT	AGAAGCGGAGTGAGCCCCAGCCAGAGG
CTTTTTGTTGCGTTTTCTCCAGAAGGT	TATGTTTCAGAGCTGGGAGGCAGTGAGTT
CAGGTCTGAGGATTTACAGTGATAGCT	AGGCACTGATAACCTGTATTCAGGTGG
CTGTCCGAGAGTGTGACCCTGA	GTGATCCTTGAAAGGTGCAACTGATGA
GCGGCTCCACAAGTAAGACAGAG	CATCTCACTGACTCTCAACCCTCACAA
GGTAGTAGGGAAGAATGTACTCGTGTT	AGTATTTGTTGCTTTGATGCAATTGCA
CTGTTTGAGTTGCTTCAAACTGATGGC	AGCATCTTTCCATTCCTCTCATTATTA
CGATGTGTGTTATATCCCCAGCATCTA	GAGTCTGTCATGAAGCTCCTTAGAGAAG
TCCAATCATTTCTTGACCAGTGCTTAC	GATATCCGATAAAAATGTTGTTAAAAGAGC
CCCCACCATTAATGTGCTGGAATCA	TTCAGTATAAAGACCAGAGTTATCTCAAG
CTGCTTCCCTATCACTGTCTGTATCCT	CAAAGTTCTAAAACTCATTTTGATGGAAG
AAGAGCCTGAAGGAAAGTTGTATGAAG	AGACTTAGTGCCTAATTATTGCAGAGG
GCGCACTTCCTCCTGAATGTACC	GGAGAGTGCTATCATTTATTACAACTAGA
AGATTTAGCATTTGGTCCATCTATGTTGG	AAAGGAATGGCTCTATTTAGATAAAGAGCC
CAGCTTTGTTATAGAGACATAATTGGG	AGAATTTGTTCCTTTGAGGCAATCTTG
CTAGGCTATGCCTGTTTTGTCCAAGTA	TGCCTGATTATTAGGATTCTGTGTAGC
CTGGAGAACTGGGTAAAGACATGTACA	GAGCCATATGCTTCTTCTCTTGGAAAAA
GGCTACAGCTTAAGGTTGTCCTTTTAT	AGCATAGATAATTTTATTGTCAAGGTGAA
GAGGATACACTAGATTTTTAACCTGCT	TGTTGTAGTAATTATCATCATCTTTTGGTT
CACAGGTGATCATATTCAGGCTGGTT	TTTTTCCCCTCCTAAGTTCAATAAGTT
TATGCAGGCAGCTGTGTAATTGGATGG	TCCTCTGAAACAGCTGCCTTAGCTT
GGTGTGTTAATTTCTTTCCCTTCCCTG	TCTATCCATCCTCAGAGGAACCTGGTT
CATGCAGTAATCATACGCAGTAGATCC	GGGTATATATTGCCTGTTGGATTTTGGA
TTGACTGAGCTGGTGGGGACTGGGGG	ACCCCGCCCCTCCCAGGGGACCTC
AGAACTTGCCGGTTAAGCAGGCCCCC	TAGGAGCGGGCACAGGTGGCTGGGAGGGG
TAGCCATCTGGTGATGGGACTATGAAG	ACAAGTCCAAGAAGAGCAAGAAAGGG
ACGGTCTTCAGAGAAGCCATTATCTG	CACCCATTAAGCAAGGTATGAAATTGAGAA
CATCCACTCACAAGCCGGGGGATATTTTT	TTGGTGACTTGGTCGTTGGTGGCATCA
GGGGTTCAAATTCTGGTTGAAAGATGG	TAGGCCAGGGTGGAGAGGGGATCCAC
TGTGTGATATCCCTAGACAGGATTTAC	AGGTTGGAGGAGAAAAGAAAACCATTT
ATAACAGCCTAATCTCGTCGCCCAC	AAAATAGGACAAAGCTGCCCTGCTA
GGGGAACCGTCTCCACCATCCATCCAT	CAACAAACACGGCTTAAGCAATTCC
TCAAAAGATGGGAGAGAACAGTGAAGA	TGCACGTGTATTTGCCGGTGTTG
CCCTTGAGGGAATAATTGGTCACTTCTG	TAGTGGCCCAAATGGCTGCTTTT
CTCCTTGTATGGGAAAGAAGACAACGAC	CAGGAGGGCAAGTCAGTGCTGTCGGAAAAA
AACAAATTCAAAAGCAGATGACATTTTT	TCCACAGAACAATGCAGACAGAGCC
GTTTCAGGACAGACTCTTCTGAAAGAG	GAATGAAAAGAAATGTGGCCCCTCAAA
CACATGAACACTCCAGAATCATTAACTCT	AGCAATTAACTTCTCCATATTAACTTTCAT
AGGCAACGTTGACTATCAGTTCAGC	GAACAGATTCTTAGAATTTTGTTATCACTG
TGGAAAAGGGGGTAATGTGTAATCCCC	TTAGAATGAAATAAGACAGAAAGAAACCAT
CAAGTTGAGTCCTTGCAGCTGTTACAA	CAAAGAAAAGACAACTAGTCAATCACC
AAACATATTTGAAATTCAAGTGAATTGCA	GAAAACAGAAATGGCCATATGTCAGAGT
TATGGTAGACAGAGCCTAAACATCCCC	AAAGGGAAGAAAACAAAAGCCCTGGC
GATTGCAAACCCTTATGACCCCATGAA	AAGCACATAAGAAAAGGTTAGAAAGAAG
CTACCATAAAGCAGAACTGGTCTGCAT	GGGAGAGATGAAACAAGTCATGACTGAA
ATGACATTCTGCATTTTAACTATGGCT	GTGAGGAAGAGAGGATTTTTCTTAGCAA
GCCCAATTTGCAACCTAAGATTAGGAG	CAAGACAAGGGCCATTTACTATCCCTC
AGAGTCCGAGGGCCACCTGGAGTCTC	TAGCTGCGATGGGATCCGAGCTCTGGT
CTATCCTGGAGTTGGATGCAAGTTGAA	GGAGAAAACAAGCCCATAGTCAATACAG
GTAATACTGGACCAACTCAGCCAAAGT	GAAAGAAACCCAAGGAACGAATTTACCTA
ACCTGTATGGAGGGGAGAAATTTGC	AATGCATGACGGTCTGTGTATGACTC
CTATTCTGTCTACCTCTGTATGTTTGC	TGTTACCTTTATGTTACATTAGTGTTTTCA
CCAATTCCAAACACAAGAGCAACTTCT	CTGATCGAGTACAGCAGTTGATGTAAAAT
GTATCCAAGAGGCCTAGCAAGAGAATG	CGAAGGAAACATCATGAAGAATAAAGAG
TCCCACCCCACTTTACATATAATTGAC	GCCACTTGAAAACACATTCTTTGCAG
ATGAGGGTCAGCCCACACCACC	TTTCCCCTTGATGCTCAGAGAAAGGCCT
CACGAGGGTTGGGCGTGGGGGCT	TCAGAAAAAGTATTGTGGATTTCCTAAAAC
GGCTGGACAGCATAAATTAATGATTGGTT	TAAGTGCATCCACTTGGGGCTGGTACA
CATCCCTGATGTCTGCATTTGTCCTTT	CGTTATCTGTCAAAACTATGCTTGAAA
GTGTCAAAGCTATAAAAATCTCCAGTGC	ATAAAGTACACACCTTCATAGATGTGT
AGGACGGTGGCCGGGCCCAGGGCCCGGGAT	CACCACGTCGCTCTGGTTCGGGA
AAGCCAGCTCGCCCTCCTACCACCTG	ACCAACATGGCGCCCTCCGCGCGCCT
GCCGCCCACCATGGAGAACTGGTA	GTGAAGGCGCCTGGATAGTGCAT
TCCTAGGCGGTATCATCCTGGGTA	TACTCCCCGACGCCGGTCACCTCGGGC
CAATTCAGTGGAAGGGAAGGGAAATCT	AGAAGTCAGTTCTTCTGTCCATCCCTC
GCTGCGGGGGCCCCTTTCCAGAAT	CAGCTCGCCCGGGTGGTCGGCCAGCA
AATCGGCTTGTTGTGATGCGTATCCCC	TCCGTGCTGCCTACGCACTGGCGC
CGTGAAGCGGCGGCTCGTGCTGGCATCTA	GGAGGGAGACTAAGTTACTAACAGTCC
TTTTTAATAGGGCTTGGGGAGTCCCAG	GAGTACATGCTGGTCTTGTAATATCTACTT
CATAGGTAAGGGAAAATAGCCCCAGAA	AGGAGTTGGCTTATATGATTGGCTGG
TTGCAGCCCCGGGGTGGATGAGAGG	TTCCGCACCTGGGGCCGCTCGAGCGCA
AATCTAAGGGTGAGGCAGATGCAGACA	GCGTAAACTTTTCTTCACATTTATTTTTC
CCTTCTTTGGATATACTCCAGTGCTCA	TAAGTGTGCCCGCTGTCCAGTCTT
CAGAAAAGAGGCAAAGATAATAAAGCTAT	TCCAGGACAAAATAAATGAATATTTTTGTC
CCTACTATGTACATGATATTTGATGCAAT	CTTCATGCATTGCTCCACTAATGGAG
ACTGCATACCATTACTTCAACATGTAT	TGATGAAAGACAAAAATCTCAAAATGCT
TTCCTCGTTTAATCTCCTGAAGTACAG	AATCTTTCCTTAATAATCAAGTATCTGCTC
GAGCAGAATTTGGAGACTTTGATATTAAA	TATAATAAAGGATGCTGATGTTACTGAAAC
AACACCATTTAAGAACAGAGACTGAGT	AGGAAAGAGAAATAATCGTAAGCCGTA
TACCTCTTCTGCCTTCTGGTTGTGGC	TAGGGCGGGCCTGGCTCAGGAGCCAGT
TTTTTAGTTTCTGAAGAAGTGGAGTGG	AAAGAAAGTGGGGCCTGGGAGGGATG
AGGCCACACTCAGTCAGTCATCTTTC	AGATTTACCCTTCTACTTGGGCCTACG
CTCAAAGATTGAAGGCTGCAAAGGAG	TGAGGATCAACCACAGGGGTGTGGT
TGTACATTGGTTATCTCTGGCTGATGA	AGGAAGGAAAGAATTAAAAGACAGACT
TTACTTGACCCCCTCCGGAGAATGTGG	TTGCCTCGAACTCGCCCTTTTCCTAC
ATATCCTCTCACACCCAGAGAGAACCA	TTTTTGCCCTCCCGCCCTGTCTGGATCCCT
GTCATGCTTAGCTCAGTTGTTTTGTGG	TAAGAGCTCATGTTCCTGGCTGCTGCTT
GACTCAGAGTTGATGGTGTGTAGTCAT	TTTTTCTTAGGCTTAGCTTCGCG
TCTGAGCAGTGGTCATTTTATGAATCA	GAGGCGCTGCCTTTTGTTTCTAGAATA
CAAGCGAGACACACTGGTATTAAGATTG	ATCCTCCTGCTCAGCCTCCTTAGTAG
CAACTAAACTTCTAAGATGTGGCAAGATGG	TCCATGTTATCTATATCAGGTCTCATGG
TCATTTCTAATTTGGCAAAGGTATTTACAT	GAGTATGTCCGTAACACAACAGCTAGA
CTCTGTTATATAAAAAGGTAACAGTTGGC	AGAGTCCTCTGGTGGGGAGGGGTTTTG
CCAGGTGGACAAAGTCAACTTCCAGTA	CTGTTCGTAAAGAACGCTTTGCTTCTG
TAGCAAGGTTACGCTAAAGGGTACAGC	TCACAGCGAGAGAGATCAGGAAGTT
AAGTCCTGTGAAAACCACCTCAGAGCT	TAAAAATAAGGGCAGGAAGAGGGGAG
GGGGTGTTAAAGACCAACCACTAACTA	TGGAGAGAGCATGAGGCAGAAAGAAA
GTGAACTTACACGAAGAAGACCAGCTT	GGAAAGAAAAAGGAAAGGGAAATCGAGA
CATTCTGGGGAGAAAGGTCCTTTACAC	CACCGCTCCAGGTCACCTATCACGACAAAT
ACTGACAGAGGGTAGGACTCCTGGTGG	TGCACATTATCCACGGATGGCCTG
CCGGCTGAGAGAGCTCAGGGAC	CCCGGCACTCCGTGGATTTCAAACAGT
CTCCAATCCAGGGATAAGGACTTCATT	CAGAGGAAAAGGGCAAGAAAACACTGT
CAATGATTGGCTTTGGGTATCCGATAG	GTTTGTTCAAAGGAGGAAGGGAGAAAAA
TTTCTGGGTCGCTTCCTTTTCCACTCT	AGTGGAGGAGGTAAGAGATTCCATTTT
CTTCATATAAACGGTCTGTGGCAACTG	TGGGATTCAGTAAAAGGAGGGCCTTG
AAGACTCTCCAAGAGGCTGAACTCTGT	ACCCCTCTGCAAGTATTCTCTTTCCT
CGCGACAGTAATCTGTTAAGCCATTTA	GCAATTTCAGAAACTCGTTGAATACTT
CAGTATTTTCTCACAGAAAGAATGTCTTTG	GGCAACTATTTAAATAATTCCATTTGGGAA
ACGGAGCTGATTGTAGCAACATACTAC	GTAAAATTATATGGTTATCGAACTGACCC
TCAGTCTGAGAACAGCATCCTTTGGT	AGAAAAAGGATTTTAAAACTGCACTAATTT
TTTAGTGGCTAGAATAATTCATGCTGT	AATAAAACATTGATCCATCATAACAGAACT
GCAAAGTGGGAAGAATTTCATCTCCTAAT	AACCCTAATTTTCAAACAGTAGTCTTAATT
CTGTCAACTTTCGAATTCGAGTGTGTG	GAATTTGCTTCTTCATTCAAACATAGAAG
GAATACTTTCCTCTACTTCCTATATGACT	AAGACACCTGGTCCAACCTTCCATTCAG
AACTTATATGATCTGCTAGTGAATGAGAT	CTTTTAAAACCTGTGTTCTCACAAAAAGCC
GGTAGAAGCTGAGATAGTATCATCAGTAAT	GAATCACCATCATTTCCATAGTACTCTAAA
GATTGCAACCCAATTAATATCAAAGTATCC	AAACTCTGGAATAAAATTTGGTGTATTACC
GTAAGTCAGACATAATGCATGCTGAAC	AATAAATCTGACTTTTGTGAGCTTTCTAG
AGCTTCTATTTACTTCACACATATTTTGC	AGGTGACTAAATGAACATAAAAACTGTTAA
TTCCAGGAACGGTAAAAATGGGAATAG	CAGGCTCTCTCCACTTATTTGATGCCA
CTATACCACATTCTCTCACAATGGTTAA	CCTAGTATCTACATCATTCAAAGACTACT
TCAGACAACTTTTGACAAGATGGACTT	ATATGATTCAACTTTGGTAAACTGTTAGG
CTTTATTAGTATAAATTCTCCTACCTTGGC	CAAAAGTTCAGTTAACTGAGTTAAAGGT
GAAGCATATAAGTCAGAATTATTCCAGAA	CTTTAAGTTCTGGGGTACATGATGTAGAGC
CAAGGCTACAATGAGTTGTGACAATCC	TGTGAATAGAAGGAAAAATGCAAATTCC
CAATGAGGCCTCTTATACTGCCAAATC	CAAGGAAGAGAAACAAAGATGTTCAAG
CATTAACAATTTCCTCCGAATATCAGCTG	AACTCAAATTTCCTCCTCTTCACAAAA
GCTCAGACCAATACTGTGTCCTTTAGG	TCTTTGAAGAATTGAAATTGCTTTCTTGAG
GGTGAAGTAATTTATGGGATATTCATAGC	GCAAGCAAACAAACAAACAAAAAGTGAA
AAGCCTGTTTTTCGCAGATAGGGCTAC	CATTTCAGAAACCTCCTACTCACTAATCC
TACTGACGTTGATAGCTGTGGTTTTATCC	TGGCACTTATTTAAGACTAGGAAACAA
GAAGATTTAGCCATTCCAAAACCAGATAA	TTCAACTTTTCTTGATTTCCTCATCTATG
TTTAGAAGACTTTATGGCATCTCATTTAG	CCCCTCACCAGCAACACACATACCATA
GTTAGAAGACTTTTCCAGTCCTCTTGA	TCAGCATTAAAGTATCATACTTTATCCAGA
ATGAGGTGAAGTCCATTGCTAATCAGA	ATTTTTATGTACTTTTCATTCCCTGAATGA
GACATTGAAGGTGTCAACCAATAAACT	CTGTGAACGTCAAGACAGCTCAAAA
AATGCTTTTTAACTTGGTTTTATGACAAT	CCCAAATTCAAAAACCATTTTTCTACTGAA
TGATTAAAGCAACATTTGCCTATATCAGC	AGGAAAACATTCATTTACAAGTTTAAATGG
TCTCGAAGAACAAAGGCCCAAGCTCC	AGATACTCGGCTACAATAAATACACTTTAT
TTACTGAAAGATATAAAAAGTGGCTTAGG	CCAGGCTGGGTGCAGTCACGGCTCACT
CTGTGACAATGAAACCAAGAGCAAGAC	AAAGAGAAAATGTAACTTGCTTTTAACAC
GGCAACAGAAAACATACAGTAAAAATACA	AATTAGTTTAAACTAGCATGAAGACAACA
TCATTCTCCATGAATGTCATATTGAGAT	TTCTATTTCAGTAGAGTCATAGGTAAGAG
GACCCACAGCAAACAGAACTGTTTTAG	AAACAATTCAAATGCCTATCAAGTACA
CAGCTGGTGAAAAATCCCTGAACATG	CATGCCCCGTTGACATATTAAATTTCTAA
AATGAATCATGGAGAAATCTGCTTTCTAC	TAACCTCTAAATTTGTTTCTTCATCTATGG
AACACTTTGCAACACCTTCACCTAAAA	CAAACAAAAATATCTCCCCTCAGTCCCA
CTGCATAGAGTAAAGCTGTAAAGTGAG	GAAAATTACAAATTCCCAAAAACCACATT
CCAAGGTAGCTCAGTCTTGTGCT	AAAAAGGAATATGTAATTCCTGTTCTGAA
TGATGCTTAGTCCAGTAAGTAAATTCAG	TGTCACAAGAACACCTCTTTTAATGAG
ATCTCTTCATCAATGCAAATCCTTACA	ACTTAAAAACAGAACCCTAAGATATACATG
GATAGGCTCCTGAAAACTAAAATCACT	ACAAAGGAACTTTTGTAGTGACAAGAC
AGAAACACTCCCAGCTTCTCAAGGA	ATTTAAAACTATGTCATCTTACCTCTTGAC
AACAGTAAAACACTAATCCAGCCAATA	ACTTTTACTACTGATACTACTACCATGAAT
GATCTTGATGAAAAGATGAAGCATATTCA	GGCAAAATCTTAAAATATAATGCATTACCA
CTTCTCCACTTAATAAGCAGTTGATATAAT	AAGTTGGGTTTTTATCCCAGGGAAAAA
AAACGCTTCTTATGTAAAGCAGTTGAA	TGATGTCAGGAATCGTGTATACCTCTT
TTGCCAATATTTAACCAATTTTGACCT	AAAATGAAGAGATTTTAGTGACAAACTGA
CACTAAAACTCTAAGGGCTAAGCCAGA	AAACATGATTGATAATAGGTCAGATACAC
AATATGGGCATGAGCCACTTCACCCAA	AAAACACAGAGTCATCTGAGAATAGCA
GAATTTTTCCATGCAGAAGTAACGGAA	GATGAACAGGATACATTACCTACAAGAAG
GGATGTTTGCCAAAATTTTCAACCAGT	CTACATTCTGAGTTGCAGGGGGATGATA
GATGTGTGAAAAGGCTAAGTGCACAAT	GTCAAACACATTATAAATACGGATTTTGT
CGTGCCCGGCCTATAGTTTTTATTTTT	AGAAAAGACACTCTGAAAATAAAGAAGAG
CAGCCTAGTTCTATTTTCTTCCTTTTGCA	TATCACCACAACCTCTACCTCCCAGGTTC
CAAAGAGAATCTAGTGATTACAGTGTCCC	TTCATCTCAACCAGAACTAAGTCATTTGTC
CTCTTCCCTGGCTAACAGTTGCAATTT	CAAAGAAAAACAAAAAGCTTCACTTAGAA
CACCTGGCCTTAATTTCCACATTTGTA	GCAATTAAGACAAACAAAGAACCAAGCA
GTGTACCAACAATAACATGAAGATGGTTTT	GCATCTCTAATTCTTATATGCCTTGACATA
GCCGTGACTTACTGTAAGGATGCTCTA	TGAATTAACCTTTGTAATCAATTACAGAGC
ATCATTTATTACAGTAAGTTTTGTTGGCT	AAAATCAAATACAGTAGAGGACCCTTTTC
CTTTATCCAAATGTCATGATTTTCACTTAG	TACAGTTAAAACTAAATCTGGAGGCAA
GGCCTGGATGATATAAATCTGTGGATTCC	TGATACTGCACATCATCTTCACATAAT
GTTGTTGTTTAGAATGAGGAGAGAGGC	AAGTAATCAAAGATATCAACAGAAAACCA
TGTATTTCCATTTCTTAGAGGGAATGG	AAGACACAAAATTAAGAAACAAGGTATTTC
CTGGCTACCTCTGGTTTAGTCAGAAAT	ATACTGCAGTGGGTAGAGCGTGTATGC
TGGCCTTAGCAAATGCAAACAGAGATG	TCTAAAATCGGTTCAAGGCTGGCAC
ATCTCTACAGAGAGTAACACAGCAAGA	AAAAACATTACATAAGGAACTACCCAAC
CTGACAGCTGTCAGCTTTAATAAGCC	CCTTTTAATTTTAAAAGGCCATTAAAGAGC
GGACAACTGTTTATGCTGAAAACAAAA	AAAAAGAAACAAACAATCTGAAATCACTG
TCAAACCTCCTAACTTCACTGTATTCT	CTGGGCATGGTTCTTTGCACCTGTAAT
CAAGTGGAATGGAACTCAAAGACAATAT	CAGAATGGTTACTTCAGAAAAGTTTATGAA
TGTAGAATCTGCATTCCCAGAGACAAG	ATACTCTTCCTATCAATTACTGACCTTAAT
TCAATATGATGGCAGGAGGGTTGTTAG	CAAATTGCTGATCCAGTACAGTCCAAAA
CACACCTTTACCATAAAATCATATGCTCC	ATATGAGAAAACATGGTAGATTTAGTCAAG
GGATCTACAGATCGGACACTCAAAGTG	TGACAGTGTGCTCTTAAATTAGATTTAATT
GTGTATACATTCTCCAGTCTCTGCATTCC	AGTTACTTATTTAATTTGTTTGGCTCTTCA
ATGCCTTCATTTTTCTCTTCACCAGTA	GTTTACTCTTCCTACACTTCACAAAGT
GGTTTTGAGCAGAGAGATGGAATACTC	AACTGAACTCTGCACAATGTAACAGAA
ATCAAGTATCTCATCCTGTGGAGAATA	AAGGTTCAAAATTGCATAGAGAATATGTT
ACCCTGATCAACTATGGTTGTGTGTAG	AGATTATCAATTACATTCTTCATTGGGTG
AAGTATCTATCTTTGCTTTCACTTTTGTT	CATATCTAAACATAGTACTTGAAATGCCT
AGGAACACATGCAACTCTCCTTCAC	TTGGCGCCTAGCTTCCCTCTCCTGT
GTACACTTGCGGGACTGCCGCACCACATT	AGAGGCCAGTCAGGAGGGAGTGGCTA
GTGAATATTCAAACCTGTTCCCACCTC	TGAGGACACTCAGTGGGGGCTGATTT
AAATGCCCCGCCTAGCCCTTCAGTGG	GAGAGATAAGTGTAGGGATGTGTGTGG
CTGTTGATTCCATCCCCCAGAGTCTCT	CTCAGGTGAACAGGAATTTGCCCCA
GAATGGAAAACGCTCTGACAGATGTC	GGTTTACATATATATTAAGGCTTGTGTGT
TGCGGCAAGCACCACGCGGTGGCAGGAGAA	GTGCCAGGGGCCCTTCCAAACTCTTCT
AAGTGCGAGACTTCCTGTTATGTGTG	TTCTACAGATGAGCCCTCCCAGAAAAC
AAAGGCAACGATGCTTTAGATTGATCA	TAGAAGAGAGTGAGATGGTTAGCACCCC
CTTCCACCCAAACTACTTTCTGTGTGA	TAGCACTAAACATCATAGTGTGGCGG
GGAAGAGTTGGCTCTACCTCTGAAAAC	CAGCATGGGAGTATTTGACCTGCTCT
CTCTGCAGAAATGTGTGTACTCGCAAA	ACCTGGCCCTGTTTTCTCTTAAAGC
CGTTGTGAGATGGACATCAATGAGTG	CAGCATTTGATTTCCTTTGCTGACTGG
TCATTCTGGCAGGGGTCTGAATG	AACAATAGAAGAGCATCTGATGGTTATAGC
CATTTTCTCTTAGTTGTCCTTTGCCCC	GAGTAAGCAGAACTTTTTCTGTTCTGTG
GAGAACATTGATGATTGTGCCTTCGC	TCTATGGGAACATATCACTCAGGACTG
CAGGTGGAGCCTGGAGTACAGGA	AATTACTTTTGATTAGGGCTCTTGAGTCTC
CTGAAGTCATGAAGCGGGTCTATTCTA	ATGTACAGTGTGGAGAATCCACCAGA
TGTGACAGCCTGTATGTGCCCTGTGC	GGAAGTGAGAATTTTGTGTGGGGTG
CAAAAGTGAAGTCACCAGTCTGCCGA	TGTGAAGCCTGTGAGGCATTTGCA
AAGAGCTCGCTGATGTCAATGAGGTA	GGCAGAAATGTGAGACTGATGTCAATG
ATCTCATCCATGCTTTGTGTCTCGACC	CTGGTGCACATTTAACATTATGATAAGGA
GTGCACTCATAGGTATCCCGGCTGA	GATGTTGACAATATTCCCCCAAGAAGC
AGGACTCTTTCTTCTAAAGGGAAGCAG	AGACCCCTGTGAGAAGAACCGCTGC
GAAACCCAGATTAGGTGGGAATGAATG	TCATATATTTTCTTTTTGCGATAGAACACT
ACAGCGCCCCTCAGCCCGATACTCA	CTTCAAAGGCTCAGGCCCTGGCGCTA
TTCTCCCACCTTCTGCTTCTGGGTAA	CAGATAATCAAAGTGGGAGGCTAGAGAG
CAGCAGCGAAAGCGCCTTGAGGCCTTT	GTACTTAGAAGCCTGGGGACCAGGGTA
TAGCTGGTCACCTCCCAGACCAAAGAT	GAAAGGTGGAAGAAAGAGAGGTTTTATGA
AGTGTATATAGACTCCAGACAGGGAAG	AGATCGAGAATACCAGACCAGTTAGTG
GTAGCAAGACCAAAAAGAGGGTAGGAG	GAGGAAAGGGAATGTAAAAGAAAAGAAAA
TTCTTGTCCCCTACCCAGCACAAGAC	GCAGGGAAGAGAAAATAGAAAAGGAGGG
AAGATGGGGACACACCAGGCTACTCAC	CAGGAGAGACAGACAGTGATAATCACC
CATGCCACATAAGTCTTGGCACTCTAA	GCAAACACATGTTGAGATAAGAAAAATGCC
GCAAAGGAGACTGGTGTTTGGTATTCT	GAAAGACAAGGTAAGAGCTGTTGCCT
CATGCTGTGTTCTTCATCCTTTGTCAC	ATGTAAGGAAACGAGAGGACGTGGTG
AATCAGTGCTTAGTCACCGATACCTCG	CGGGTAACGCGCTTCCAACTCC
TGAGGCAGAGAAAAGACCTCTTTACTC	CATAGTCCAGGCCTTACAGTTCATTCTT
AGGTCCACACATTCCTCTAGGAGGAAA	TCCAGGTGATCGCAAATGGTAAGTAAT
CCTGAATTCATATAAGTCAGTTTTTCAGA	AGACCGGGGACACAGTGTAGTTGGTG
GAGTATTTTTAAAAGAATCCCTGATGTCA	AAATCACACTGACATGTTTTTGAGGAA
AAGCCACCAGGTCATTGTCAGTTAGCT	GCAAAAGAATAAAGAAATTTTCTCAGTGAC
AAGGGAAAGGTGAGAAAAGAGGACACC	TCCACGTATCTATGGCATCCGGAAAA
CCATCCCTGGGAATCTGACCCTAGCAA	CAGCCAAGCCCCCAGCTGCTCCT
CCACCCATTTCTCACTGTCCGC	CTCTTTGCCGGGAGCTGCTTAA
CCAGAGGAGGAGGATGAACTAGGCTCA	ACTATATATGTCCACCTGAGATCAAGATC
GACCCTAAGAAGTTGAGGATAAAATGG	CTCCAAATTCTTTGGGGGTTTCTTAGC
AAGCACATGGCACGTTCCTGGGACAG	CTGGATTCCTGTATTTTTCAAACTGCC
AGGAGGAAGTCTGGAAGAGAAGAGGA	CCTGTGGTCATTCCCTGTTCTTTCCAT
TTCAGGGCAGCATTGTGAAGCTGGATC	TATACTTCTTGTGCCCAGACTGCAGGTTCA
ATCTTCTCTGCCTGCTAGCTAGACAT	TTTTCTAGCTTGCCTTGTATCAGCTATG
GCTTGGATATCACAAAAATGTCAAATTG	CTAAGTGATCGTCTGAGCAAGCAAACT
GTCAAGTGTGTGTCGCTGGTCCACCAT	TCTAGTTAACCAACACTGAGCTTTCCT
AGATACACATTGTGTGCAGTTATCCTA	CAGAGCTTATCAAACGATCTTTGATGAAG
TTCATTTCGGTATTCATTTCCAACTTTCAG	ACCTTAAAACCAAAGCACCAGCA
TTTGCAAAGGAAGCCACGGGCTCAAGA	GTCATAATGGAGAGTTGAATGTTTCTGG
TGCTTCATCAGTCCAGAGTCTGGCAGA	AGCAGCTCTGCTGAGTGCAACG
TTTCTGGGCATTCTTGACCCAATCCAGG	TTGGGGATGGAGCCACACCTCCCAAG
AAAAGATGTGATAAGTCAGACCATACC	AAGGCACCCTCTCTGGATCCAACCAA
GGATCCTTCTTATTCCCCTCAGAGTTG	GTCATTTTCAGGATTACTGGCAGAACTC
AAAGCCTTGGCTTCTGGAATCACCAT	TGGTCATGACACCTCCAACGTGCACA
GTGGACTTGCAGCAAACCAAAACCTA	TCGAGACGATTCATGAGGGAACTTC
GCTTTCCAACTTTCTTGTGAAATTTCATC	CCCGCTTCTTTTTGACTGGAGTGA
AAACAGGCCTGGGGTGCTTGATGGCTG	GCTGGAACAGGACAAGATCTGATTCAAG
GGGCAGGAAGCCAAGAGCAGAG	CAGCACTGAAACCAATTTTTCAGAGTTG
TTTCCTTTAGGGAGCCAATCTCGCACA	AACTGTGTTGAAAGTGGGTGCATAGC
GGAACCTGGAAGCTGTCTCCAC	GTACTCTTTTGATTTCTGCTCCCTGGAC
TCCAGGTCTGCCAGAAACTGGAG	TCCTTCGGGATTCTGAGCTCTTCTC
TTCATCTTGCTTGGGGTGAACCCAAAG	AAAAATAACAACCCCAAAGCTTTCAG
TTCACGTGGTCCAGGTTCTTCTTGGTGG	AGCATTCTACTTGGCTATAAAGATTATAGA
GAAGCCATCCAGTGCGAAGTGC	GGTGCTGGAAAAATGCATCGACCT
TTTGTGTTTCCTCTTTCCGCCTCGGGGG	GCATTTGGTCTCTGGAGTCCTCA
TGCCCCCGCCACCCCCTCTACCCAAGA	GGCCTAGGGAACTGACACGTGGGAA
AGTGGGACCCTTTAAACCCAGTCTAA	TAAGCGAAGGGATCCCAGGGAGGGAAA
TCTCATGCTCCTGTTCATGGAGGGGAG	CCTGGCAAAGGACAAGAAAAAGGC
GTCTCTGCATTTGGTCCCCATGTAT	TAAGGGCCTTGGGGTTCCTGGGGCCAA
TCACTCAGGCACCTGGCAGCCCCACT	CAGTGGGTGCTCAATAAATGCTTGTTG
GGCAGGGACTTGCTCAAGGTCATA	GCCTGGGTAGGCCTCCACCATGACTTT
TGCTCAGGGACTGGATCAATGGGT	TGCAAGGTTTTAACTGGACCTACCTGG
GCAGGGAGGAGAGCAATATCTCTATCA	AGTCCCTGCAGATCACAAGGTGAAGTC
AGGGCCAAGTTCATTCAGAGCCA	GTGGGATGTCCTCTTTCTTTCACTTCTT
GCTGATGGACATCACCTTCCTGC	GTCCTCGAACACGACCACCTCCTGT
ACGCTGAAGCATCCGCTGAACTG	AGGACGCACTACTGCCCTGTCTG
AGCAGCATCCTCAGCACCAACAAC	TGAGTGCTGGCTATGAGCAAGGACCTG
GGTCCCCGTGTTTTGGAAGGTAG	TGGGAGAGAGGGACAGCAGACAGAAGT
AGTCGGTAGGGATCCTGCAGGAGTGTG	TGGGTGCACCTTAGTGCCATTTTT
TCCTCAGCAGGTCTCCTTCCCTGACAT	TGAGGGTCAGGACTTTTTGGTAACG
GTATTAGCCCCATTTTACAAGTGAAGC	CCTCGATCAAGTAGATTTCCAACATGC
GCCTAGCTAAAAGGGGAAGAAGAGGAT	GGGGGTGGGGGACTTTGTTGGG
TTCTCCTCTCCCATCTTGACAAGTCA	TAAGCAGCTGCAAGGAGAGCCTTTCA
TTCTCCTCCTCGTCGCAGTAGAAATACG	TCCCCTTGCAGAGCTATCCCCTAAAG
TTAGCTTCACCAACAGGAACTATGACC	CCCTCCTACGTTGCGGTCACACCCTT
GATGTTTTTGATGAAGGTCTCGTCGTC	ACAGGGGCGGGGTGGGCAGCAGCTCGA
TGGTGACCGAGCTGCTGGGAGGAGACAT	GCCACAGCGTCTGCTCCACCTCCAGCTT
AGAGAATCCGAGGACGGAGAGAAGGCG	TTTGCGCGCAGCCTGGTAGGAGGCCAGC
GTCCTGCGCCTCGCAAGACTCCA	GGCAGCTTATTTAACGGGCCACTCTTA
TCCAGCAGAAGGTGATCCAGACTCTG	AAGGTCTCTGGACAAAATTATCTCCCC
AAGATGAGGAAGAAATCGATGTTGTTTCTG	GGTCAAGTTGGACAGTGTCAGAGT
GGGATCTGGTCACGCAGGGCAA	AGTGGAGGGAGGCGCTGCGTAGTTGT
ACACACAACGTCTTGGAGCGCCAGA	AAACACAAACTTGAACAGCTACGGAAC
CCAAAGTCCAATTTGAGGCAGTTTACATTA	AACTGTTCTCGTCGTTTCCGCAACAAG
CAACTCTTGTCTTTTCACTCAAATAGC	TTTGAGGGATTATTTATACAAGTGAAATGA
CTGAAGTTTGGGAAATACCAACACAGT	AAATAGAAATCTTATCTTACCCATTGCAA
GCTAGGATTTTTCTCTGAACTGTCTGTTT	AAAATGTAAAACCAACAAAATGTATAGGC
AAATGGGCTTTAGTAGAAGCCTGGT	TCTAGCATATCTGAAAATATACTCAATCCA
CATTAATAATTCCGGCAGTTAGTAGACT	AATCAGTAAGGCATTGATGTTGATTGC
TTTGACTTGTGTAATTCCAATCCTGGA	AAATTTTCTAAGTCAATTGAAAATACGCTC
ACTACGTGCTCCCTACGCGCATGCGT	GTTGGGCGCGATCGGGGCGCAG
GCCTCTGCTTCTCCAGAAAATAACTTG	AAGTTCATACAAGTTCCTTCCCCGGT
GTCTAATATATGCACAGCAGCCAGTAG	TGCTGACATAGAGCTGTTGCAAACAG
GTGTATGTCATGCTGCTGACATATTCC	TAAAAACTTCATGTTCTTTTCAAAGACAG
TTGAGAGAGTGGGTGTGGTTCTGTGC	CCATGCCATTTTTACCTTATGTCTGCTA
TGATCCTCTCCTCGCTTGCCTGAGCCA	CCCGCCCCTCCAGGTCTGGCAG
CTAAATAACTACTTGGGGGCAGAAGTC	GATTAAGACATATACACGACGATCAGCG
GACCTATTTGGTACAAGATTTTATACAGAA	AAATGTTTTATTAAACTGAGTGCTGCA
CCCAAGATAGGCAACTCTTCATGAGAG	TGATGTAATCAGATAAAAGAAATGGGCA
AGGGAACTCTGGTGTTATGTCTAAACT	AAGGGGAAGAAAAAGTAACTTTGTTTC
CCACAGGGGTCATGAATACCATTTGTA	AAATGGTGCAAACACAGGACTAATAAA
GCAGATGTCTGATGACGGACATTTGAA	GAAAATAACCATGACTTTACTGGTGGA
ATAGAGTGCTAGCGTGCCTGACCCCAGCTG	AGGCTTGCGTCAGGGTCATAGTC
CAAACAACATTTGATGAATGGCTGGTT	GGGATTTTTCCACTGGATATATAACTTTC
CCTCACCACTTGAAAATACTGGGTTTC	AACCAAAAATCAAATGATATGCTTTACAG
TACACAGTAGAAAATAGTTCTAGCATATCC	TCTGGGAAGCTAATAGAGACATCTACTTG
GGATTCCCCATTTCTTTTGTAGGAGTGG	GAAAGTTGCAGTGCTTTCCTCTTGGA
CAGCAGGCTGCGGGGAAGGAGAAA	CTCTAGGTCCCGAAGTCGTGGCA
TGTTCTATTGGTGAGAACAACGGGC	AATGATCCTCCTTCCCCCACCTCAGGCAG
TTCTTCAAGGACAAGACCATGCTGTG	TGCCTCACCAGATGGCTGACTTTC
ACAGCAAAAGAGCTCAGCTCTTGCT	CAGGGCAACCTCCACATTCATCAGT
AGACATGCGTCGCTGCTGTTTCTGTC	TGTGCCAGCGAACTGGTGCCACCAGC
TCCAGGTTCAGCAGACGGGCAG	GCACTCCTTTCCATTTCTTGAGGCGA
TACTGAGCCCTTGGTTGAACTTCCCACC	ATCCAGAAGGGCAGTGGGCGGCAGGAG
GGGATGAGGCCAGTGGCAGAGGTGA	TCTGGGGCGGGGCTCTCCTGTA
CGCAAATCAGTGTTGTAGCGTCATAG	AGTTCAGGGCCCAAGAGGTGTAGGCTG
CCTTCATCTTAACCAAGGGTTCACACT	ATACAGTGAGACCTGGCACACTGAACA
TTGTCACTTCTTCTGTTCAAGTGTGTA	TAAGGAGATGCCTCCTATTCCTCCCAT
AATGTGGTGACAGCCTTGGTGTTGGAGG	ACCCTGGCAGACTGCTATTTTTATGG
ATGAAGAGGAAGATGAAGAGGAAGAAATCG	CCCTCTCCCTACGTGGAGAGTGAGGAT
GCTCCAGGATGTTGTGGTTTCTG	AAGGCATCGTTTGAGGATCAGCTCGC
AAAGGCTAAGAGCTTGAGCCCCCGAAA	CTCCCTCCAGGCCGAGGAGCACCAGCTTTT
GTAAACCAACATTCTTAATGTCAACACA	GGACATACTCAGTGGCCTTTTTCAAAATG
TGCAGTGTTGGAGGTCGGCGCC	CCTGCTTCTACCCGGACGAAGATGACTT
AAGCAGCATCTCCGTGACCCAGCTCGG	TTCTTGCAGATCATGCCCGGCATGGTG
CACGCCCCCGCTGTCGCCCAGCCGT	AGAAGCTGGAGCGCGCCGTGAGCGAGAA
TTCACGGGAAAGGGGAAGACCACGGCG	AGTCCTGGAGGATGACCGGGTTGGG
TTTACCCCGAGGAGAGACTTGGGGGAAA	TTGTGGTCGCCGCCGCTGGTCTGGCGGCC
GCCTGTTGCTTTTAAAGGAGACAACTG	GACAAAGTTCAAGAAATGGTCTTATTCA
CCTTACAAGGTCATTGTGCAGTGATCT	AGTGATGTGTCTTGTTCTCAGCCTG
AGACCACCCAGTCTCGCCCTATGCCGCC	TCCACATCGGGGCTGGGCCGGTGCTCC
CGCTGCAGAAGGGTCTCGCCAGCGTTCTTA	CCGCTTTCTGAATCTCCGGACAGTCA
AATGAAATCCCTTCCCCCAAACCCTCCTT	CGGAGCCCAGTTCGGACTATGAT
ATCCGGGAAGAGACTGTGCAAAACCAA	TCCCCCACACCACACGTCACTCC
TAACATCACTGAAGAGAAACCTGGCAGG	CAATTGACTTCAACGAAGATGTGGCAG
CTGGGTTTAAGAGACTCTTCCGACCA	TTAGGATGGAGCCCTGTTAATTCAATGC
CCCACCCCATTAGTGATGCGTAAG	AAACAACGCCACTTGCTGCACCTTAGAGA
AAACGCAAAGTCTCAGGTGACAGCAG	TAGACAGAGTCGGTGAGGGGAAGCCGTGG
GTTTGGCTTTCAGCAGAGGGTCCTCT	GGGGCTTCAAAGGGATCACGGTGCTT
TTTTGTGCTAACCATGTGTGAGGACCCCAG	GAGGACAAAGATCTTCCTGTGGAGAAG
AAATTCAGCCCAGCCGACTGGGAAAGGTTG	TTGTCCTTATGAATGGTGGCAACCAG
ACTTTGGCTTTTTGTCCTGATTTCCTT	TTCATTTGCCTTATCTTAAAGGAAAGTAT
GATGAATAAAGCCAAATTGTTTTGCAA	AAACCTTTTGAGTTAAATTTCATTTCCAA
CAAATTACCACAAGCTTCATTCACCAA	CCCACGTAACCCGCTGAGTTGGCGATT
CCAAGAGGATCCCAAACCATTTTGTGT	TGTATGCAGATTCCAGTCAGCTCAG
GCTCCATCTTTGGTATAGGTGGGGGT	TGAAGACTGGCTGTTTGAAAGTATAAG
AAACGTGTCCAAACCCAGCTTTGCAGC	TACCAACAAAGAGAACCTAGGGTTGC
GGCCGGCTCAACTGAGGGCTTG	CATCTGGATGTAACTTGGTGCTGCTA
TTGGGCATGGTGCATCCCATGTTGAT	CCAACTGGAATCAAGGGAAGACTGTT
GGATCTCCTCTCTGGTTTCTCCTCTTT	TGAGGGTAGACAGGTCCTTTGCCATGTAA
GGAATTGGTGGGGACCTGAATGCCTCATTT	CCTGCTGGTTTTGGTGCCATCTGCATT
AAGGCATTGGACTGGGCGATACCACA	TTCAGCACGTGGGCCAGCCCCCGGCCACTC
AGTGATGACAGCATCGGTGCCG	AGGAGATAGTGTTTCTTTCGGAATCTC
TACCAAAGACGTCACAGATAAGCCAC	TGAAATCATCAGCACTGCTCCCTCA
TACAGCTTGGCCCAGCCGCTGTATTCT	TCAGCCCTGGGAATCCTGTTGATTCC
GACCGACGTAGTGAGGTGGCGGCAGGTA	CGCAGATAACTAGCACCATTGATGTTG
ACAGTGGAGGCTTCTGCCGTCTCTGGA	TGCCACGCCAGCCATCTACCCT
TTTTTGTATTCCAGGCGGTGTTTTGT	GTTTCCCGGGACCCGCAGCCCTT
GATGTTAAGGCTGATGGCATGTTGAAC	TCGTCTATTCTAGCTTGTGTGGACTGG
GACTTTCAATATGGGCCATTGACAGCT	AGAGATTAATAGCTTCTGTTGATGCCA
CCTTCCCCATCTGCATCCTTTATGAAT	AATGCGCCCATCTGGGCCGGGCCTGAG
CTTCAACCCTGAAAGTAAGGAGCTGTTA	TCTGTAAAGAAAGGACACTATTACATATGA
CACTCTACAGAGGAGCCCAGCAGAGT	GAGGACATTTTCAATTTCTTAAGGACATCC
AGTAGGTATGGTGAGAAATGAGGGGTG	CGCATATTTCGCTGCAATTTTCCAAAC
GACAAAAGGCAGCCTACCATCTTATTT	TGATTTAAGCAGAAGAGGACTGGTGAA
ATCCCTCTGCAGCCCAGCCCAGAGG	AGAGGTAGAGGGTCAGGTCTGAGGTC
GTGGCACAGTGAATCAAATTCCCAACT	TGGAGTGATGTGTGGTTTGGGGA
TCATTGGTGTCCCACATTTGCCGGG	CTTCCCATGTCACTGTCTGCCAT
AGATCCCCTGGACTTTGTTGGGCAAGA	CTGCAGTGCAAAGTTGTATAACTATCAG
GAGCACCGCCTCAGGAACAGGAACCTT	TATTGTAGAAGGTGTGTGTGGCGG
AAGGTCTTTTGAGTGAGAGGCTGAGCT	ACAGGGACAACTCCATGAGCAAAGAG
GATGTCCTCACAAGTTCAGGAATCAGA	TGGAGGTGATACAGGGTGAGGATAACA
GTTTCGACAAATGACTTCTGAGTCTGC	TGAAAGAAGAGCAGGCAGTGAGACAA
TGGAGAACTCCACCTTCCTACTGAGTG	TAAGGGGAGCATATAGGGGATTAGGAC
CCTATTGTATGCAGCTATCCCTCTGGT	GGGGAAAAGAATTCCAGAAAATCAAAACTC
TTGGGCATGGTGGTGATTTCAAAGTGC	CGACCATCAATGTCTCCCATTATAACTCA
TCCGATGTCTTGAAGAGGCTGAAGCTT	CCAGACCTACTTCGGCTCCTAGG
GCTAATGCTGGCATTGATAAGGCG	TCGTACCGCACCAGCTCCACAGT
GCACTTCGGGACTTAGAGGGTGTA	CTGTGTCCATGCTGTACTTTGCTTACA
CCACCCCAGTGAAACCCACAGAACCAT	CCACAGGGCGCCGTTGGTCTGAGCATCTAT
GGGAAATGCACTACTAGGCCAACAAAA	GAAAAAGAAATAAATTCTGTCTAAAGGGCA
GAGGGAACAAAAACTCTACCACCATTC	GCAGTTACATTCTTAGGATGGGAAAAGA
AGATAGGGATACTGGGCACTAAATTCG	GAAAGCAAGAATAGATTGTGGTGAGCA
GGGACCCTAGTTACAGGATGAATCAAA	GAAATCAGAGAACATTGATAGATGAAGTGA
ACTCAGAAGGCTTACCATACCAATCAG	GTGACAGAAAGATAAGAATTAAAACCCTTC
GTACAAATGAACTGGGAAGAACAACAT	AAAAATACGAGGTGGTTAAGTTATATCAC
CACACCATATATTAACTTCTGACATTTGC	ATGCCTGTAATCCCACACTTTCAGAG
ATTGACATTGCCGTACTAACACGCCA	ATCTCACCTTTCTTCTCCAATAAATCC
AGTTCAAATCCAGTTTTTGTGAATTCA	TGAAAAAGATTCTCATTTAAAGAGAAAGGA
CCTAATTAATGGTGACCAAGTTGGTCA	AGTAAAAGTATGGTGAAACTAATCTAACAG
AATAACTTGCCCAGAGTGACTCAGTGG	AACACATCATTTCTTTTCAATTGTAAAGG
GGAGATAACTCATGAATGAGAGGTGCA	GGAAGGAAAAACGATGCATAATTAGTGCC
ATGTGAAAGCTTCGATATGATCTGTAG	AGAAATAAGCAGTAACAGGTGCTTTTA
ACCCCTTTTCCAAAATTTTTCGAACCT	TTTCATATCTAAGGATCTAACAAAGGAGTA
TGCACGAAGTAAGATTTTTCTATCAAAT	AAATTTAAAAAGAGCAATGTGGTCTTAGA
ACAAAATTGTTTCATGGCTAAAATGGA	AAAAGTCAGAAAGAGTTAGCTTATTTCTT
ACAGAGTGCATGGTAAGTTTTAGAACA	AGTCTACAACACAGAGCGTACATTTTA
GCACACAGATACAGATGTTTTGGAAGC	GCCCCTCTACTGCAGTAAGCTAATTAG
ACAAGATATTTCTGCTTTGCTCAATCT	ACAATTCAGCATTTCTTTAAAATGTTTTCA
GCAACTCAGACTGCAATGAAGAATCA	CACAGAAACAGAATCCAACTTTCTATATTT
TGACATGTTAGAGCCATTAGTGTATACCC	ATATTTTATCCTTAAAAACGTGAAACACAG
CCCTTAAAGAATTCAATGGCAGCCATG	GGAGAAAAAGTCCCAAACATTAAGCATC
CACACTTTGCCCAATTTCAACTGCTAC	AGAGCTTTATCTCTTAAAACTACTTGACA
AGTTATTCCAAATGAAAGGGCTAGATT	TGGAAAGAAAGAAAGCATGTTAAAGTT
TGTCTTGTCGAAGTAGTTTAGAAGAAA	GCCAAGCTTTTAATTTGAGGAATAGAAAAT
TTGGCATTTCTTGATATTCTGAGTGAA	ACTCTATTTTAATATTGTGAGTTTTCCTCC
CATCACCACCAGCTAGCAAAGAATTTC	CAGCCTTACAGGACATTAATGAACAATGT
TGTGTGGCTTCCACTGATGTCTTAC	ATTTATCCCTAATGTTTACCAACTGAATTG
TGCAAAACTTACTTCTCTTGGTAAGTA	TAAAACAAAGTCAAGATCTGAACTAATGT
GCCTCTTTTTCTCACATCCAGCTGTTT	AAAAAGGAAATAAGTTGACATTAGTTTAGC
ACAGAGCCTTGATGAGTGCTGATATAA	CTTTATCATCTTCTGGAACACCTCAATG
CGTTTATTCAGGCAAACAAAACTGCCC	ATGAGAGAGAGAGAGGGGAGAAAATCT
TAACCTCCGAGCAGCACTCCTAATGATA	TGGACACTGGGGGAGGACTCCT
AGTCGTTCCAGGTCTCGCAGCC	AAATCCAGGTCGCGATCGAAGAGTCCCCC
CGAGACTTCGAGCGGCTGTAGCGAGAT	GCCACTCCCGGGTCGCAGACGGCGGAA
GCCGCGAGCTGCGGGTGCAAAT	AAGCACGTGGTGCGGGCCCGGACGGGGCG
GGGGTGGCGGTCCCCGGCGGCTGTGGTGT	TCGAAGACGCGCCTCAGCGTGT
AAGGCAACTGCCTGAGAGGCGCGGCGT	AAGTACGGGCGCGTCGGCGACGTGTACAT
GTTTACACTGACACCTAGCTGTGATCC	AAAAAGTACAAAGAATTGTTGTTTGACTG
TCCAATGTCACATGAATGTAAATCAAG	ATCACTTCAAAATACACTGAAAGTATGAA
GCTTCAATGTGTTCACTGATCAGTCGT	GGGAAACAGTTTTAACCAGCTGACAGT
GTAGCATCGAGTGTCTTCTTTGTCTTC	TATTTTTGTGGACGGAATCGGAACACGC
GGACCCTTCTAACTTTGTCACCATGATG	ATGTGATTGTGTGTGCACGCATGTGTG
GGGGGAGCTGGAGGCATCCCGAA	CATCTGAGGGGCTCCTGGAGAA
AAGCAAGGAGCAGGCGCCCCTCGC	AAGGCAACCCCACTATGGTGCCCCT
GTCTGCTGAGTTTCTGTGTAGTACCTT	CGTTCTGCATCCAAATGCACTTTGAGA
CGCCTCTCGCGCTCTCTCGGCCCGACT	CCGCGGTCAGGGCCCCCATCGA
CCCGGGGACAGGCACCGGCACCTGCTTTT	GGATTGGGCCGGGCCGAGGCGAA
AACCTTCCCTCTCAACTTCTCATCAGC	GTAATCCCAGAATGCTGCTGAAGTTT
ATGCCGCCCATCATCCACGCGCCCA	AGGGTATCCAGCCCAGAGGAGAG
CCGAGGGAGGCATGGGCACCACGTTGATT	AGTTGGACTCCAAGGTCACACACAGTT
AGGAACACATGCGCATTGGACTT	TGAGGAGAGTTGCACTCTATGATATTG
CCCGCTGCTCCAGCCAGCGAGGGTCAA	TGGTATTTCATGCGTGCATCATTCATC
ACCCAGAGACCTGCCAGGCTCAG	TAGGGAGGGCCTGCTTCCCAACCCTCG
GGTGGGTCTTTGATAAGGAATACCTTT	TGGGCAGGCCTGCAGGATGACCT
TCATCAGGAGCAGACCCTGCTTCAG	TAGGTCTGTGAGGAGTGACTCCAGATG
CTGAGGTTAAGTAACTTGCCCTAAGTC	AACTGAATAGCATTTCTTGCAACCAGT
AGCTGATGCAGAAAGAGCAGCGC	TTCTCCATGGGGCCTCTGAGCAAATG
TTCGTGAAGTAGTTGAAGAGGCTGTG	GGGCACGATGGTCTCTTGGATTACTT
GAATTCTCTCACACCAAGTGCTAGTG	AAGAGCCTCCTCCTGAGTTTGAGTTCA
ATGGGGATAACGACCTCACTTCTCT	TCGCTGACCTTGTGGCGGTAGTA
AAGGACGTTCCAATGGGCAGTGTTCTA	TTCAAGGAAGGGAAGGCTCAGGAGCCG
CTAGAGGAGTTTTACAGTGGAGAACCTG	TAACAGAGCTACTTGGGTGGGTCAGAGGT
CTGTATTTGCTAAGTCCAGAGCGCAAA	AAGAGGAACCTGCTGTCAAGTCCCTG
TACCTTCGCGGCCGCAACTCGCTCGGCC	TACCTCTCCCCCGCCCCTCAGCCTGCAGC
AGTTCGTGAGTTTAAACAGCTTATTTATC	CCTTAAAATAGAAAATCAGGCTGGGTGAG
ACAGGTGTATCGTCAGTACGTCGGACT	TAGCTATTTCTTTCAGATTAAAGAAAACGC
GTTATGAACAACTGGAGAACAGCATGAA	GCAGGTGTGTTAATATACAAATCATGATCT
AATTTTCTGCGCCTTTAGGAAAAGTTG	TTTTGTTTTTCACAAACACGTATGTCA
CTTTGAGCTACATTGCTTGCAATTCAGA	GGCTAATTTGTCCTTTTTCAAGAAACTAT
CAGTCATTTTCCTTGCAGATAAACTCTCC	TCAGAAAAATATCTAAGTCTATATGCTGCA
TGAGATCCTGGACCTTTCAGTGATATT	GGTAAAATTTCATTAATTCTCTACAAGCC
AGGAAGTGATTCCACCACCAATAGCT	GCATTTTTATGTATTTGCTTATTCCATGAA
TGATGTAGCGTCTCCAGAGTGACCGAA	TATAGTAAAACAAAGGAGTGATATATGCCA
TAAGACTTTTGGGACGTCGACCTACCCTTC	GTTATAGAACTCATTCATTCATTTACCCA
ATTTCTTGATAAGGTTTTCTGTGATTTGC	TCTGAATGTTTTCATTTGAGTTCACTTGG
AATTTACTCTTCCAAACATAAACTGTTCC	ACGAAGCAAGCAAGAGAAAAGATCTAG
AGCATGCACTTTGACCCTGAAGCAAT	TGGTGAGGATCCAATCTGCTCTGC
GAATCCTGGGATCCCTGAGTATAGGG	CGACTTCTCAGGTAGATGTGTACTGTC
AGGCAGCCACTCTGAGAGCTGGT	GAGCATTTACTATGAACCTCTGGAGTTTAT
TAGGTCCAACTTAGTCCGCTCCCAGT	GTGAGGAGCATCCGCTTACGCCA
CCACCGATCACTATATTGGCTTTGAAAC	GGTCCATATGATTTTGGGTCTCTCTTTACA
ATTCGTCTGTCCGTTTTCTGCAGCAGA	CACCTGGTCATTCGGACACGTG
GCAAAGATTTCTGAGCTACGGTTTACTG	TCTGCACCGCGTTCCTGCCCTGCACAG
ACTGGCTCCTCTCTGATAAGGGACCCT	GTATTATCAGAAGGGTTGTTATTTACCATG
AAATCTGTGTATTCCTGTGAGCGATGG	GGGATTTAGAGCCTTCATTCTCTCAGC
CCAACCCAATGCTCAAGTAAAACCATC	TTGAGGGAGAGAAAAGTCATAGGACCC
AGCTAAACTGACAGGGTTTTCTGAGG	TGAGTAAAGGAAGAGATACTGAGCAGG
GAAACTAGAAGAGCTGAGTACATGGCT	TGGATACAAAGAAGACAGAAACCAACC
CCAGTAAAGAAAGGGAAAGGGATAGCTG	TAGGGAGCCACAGGATCAGGGTGAG
AATGGGTGAAGAGGTTGTGCTCTAGGGC	TAAAGACAGGCAGGAGGTTCCGCGGGCAT
GGTGGGCTGAGCCGGCCCAGCTGCTC	GCGGGGGAGGCCATGATGGAGCCT
CAGCAGTGGCGTGATCTCCGAA	GGGCCTTGTGGGCGGTGACTCAGCAT
TTCTATCTTTGTGCCCATCTCCCATC	CAGAGAGACACTCGTTTTCTCTATAAG
ACTGTGACTAAATAGGCCAGGCTTTAA	GATCGTATAAATTTAATAGTGGGAAGTGT
AAGGTTTGCCAGTGTGACTCCAACGGG	TTTGACCTTTCAGCATTTCCTCGCC
CCACAATCCTGTCCACATCTGTGCAGT	AAAACACATAGCATTGTTCAGGATGTA
AAGAGGCAGAGACTTGCGAAACTCCAG	GGCATGAAAAGTTAATTTTATGTGCTTCAT
CAAGTGCTGTAATATTAATTGAATTGGGG	TGGTGAAATTCTCAAAGCTTCTAACCTTC
CCAGTTGCATTTGGAACTAAACCTGTA	TTTTTCTTGTATGTTGATGAAAGACAGTA
CCCTTATTTTGCCCCCAATCCTAAGAT	AGAAATTTTCATTGCAATCAAAACTACTT
GGCATGAAGCCCTTCTTCTTGGCGAAT	AAAATAAAAGGGAAGCCATATTTTTGCAGG
ATACACCAGCCTGGAACGCAGT	TCTTTCAGACATCTCCAGATGTGGGT
AGTAGGATCTCCGCCACTGATTCTGTA	CCGTCCGATTTTACTGCCCCATTAGAT
GCCATGCTCTCCTTGCATTATAAAGAG	GTACAGCCTGTCACTCACACAACTTT
CCCTGGAATGAAGGGTAACCATTCATT	AGCCAACCAAAAACTCTATTTGTGTTT
CTTGCTATTTTTGTAGCCTTATGATGA	ATAATAATTTGAAGATGACTTGAGGAAAGT
TGAGCTCATTTAGTCTCTCACTTAATG	TCCAACCAGCTGATAATTCTGTGTATT
ACTGTGATTCCTATGCTTTCAGGTATT	AGGTGGCACAATTTTAACTGTTTTCAT
GCCAAGTTCCTGATATATGCCCAAGA	CACTATTTGCATTTGTATCAACTTTGGTCA
GCCACTTGCCACTTTTCCTGGGTCTCTTT	AATACTTAAACCTATATCCTGCTTAGGTT
GAGGCTTTATGCCAAGTGGAATGTTTC	ATCTCAAAAGATATATTTGTACATGCAGT
TTGCTGACGGTCAGTATTCCAGTTATA	ACAAAAATTGCCTTATTCATTCCATAACA
AAACTGCCTGGAGCCGTTTCTCCGCG	GGGCGGCGCCGGGTCCCTTTGT
AACGCTGGGGACGTCACGTGAACG	TGAGGCGGCCGCGTAGGGCCCTGTGC
AGACACAGACACACACAGGCCACCCA	AAGGGTGAGAGGAGGGGCACGGGATA
ATGTAAGCTCCACTCTCTCCAGGGAAG	GGGGTGGGAGGGAAAGGTATGG
AAAGGGAATGGAGGGAAGGGGAGGAA	CAAAGGGAATAAAAGCCGGATAAAACC
AAGGCAGCTCCACACAACATCAGC	TGCAGAGGGAATAGGAGACAAGGGG
TACACAACTTCCTAAGCCACTCCAGCT	ATGAAAGAGAAAGGAGTGGTGAGGGA
TCACTCCTCTGCCCATCGTCTTCAGAG	GAAAGGAGAGGCAGGTTTGTGAACA
GTTGAAGCTAAGTCCCTCCTCTGATTG	AGTATAGTAAAGTGTTTCCAAAGAGGG
GGCTGGGGGAGTATTTCCTTACTTATA	GTCTTCATTATTTAAATGGTCAAGTGCT
TCACTCATGTTTTAGACTGTCCATATAATA	ACTTCTGTTTCATTTTTCCTTTTATGAGT
GCCTTGTGGTACTATTTGGGATAAAGT	AATTTCTTATAATTTACGTGAAAGCTGGA
GTTGCCTTGTTCTGATACGTGAGAATG	TTACTAGTATACCTAACCCTCAGAGCC
CTGCCTAACTGGAAATGCTTACTTGTG	AACATATGCATTATTCAGGTTTTCTGTT
CTGTGTCATTTAGCATGTTGCCACTAG	TTTTTCATCTTAAATATGCCGTTAAGTCA
CAGTTTGAGCTCATGGTTGTTCTCTTG	TACTAGTTGGAAGCCATGGACCGACTA
TGGTTTTTACAACATTGTTTACATCTTGT	TCTTTTATGCATTTGAAATTTGTATCAGTC
CAATCTTGATAGAGGGAAACTGTCTAG	GGCAAGAATATTTTAACAATCCCACAC
ACCTTGATAATAAGGAATAGCAGACTC	AATTGAATACATTTATTCATACCTGCTTTG
AGCACATTACAATATAGGGGATGCAGT	AGCTAAATTTCCATGCCCTGCAATTTT
GGACTGTACTTGTCTACATTTTATTTGCA	TGTTTATTATACTTTTAAGTTCTGGGGTC
GGATATAATTTTTCAGGATGGTGCAACTA	AGAATACTCCTTTTGCATATTTTTCCTAA
GTATTTTGTAGCTTGACATCTGGGGTT	TGTAAATTATGGAGATAATTCACTTTGCAG
GGTTCAGGAGGATGCATGTCATAAATA	AAACAAACGTTTTCATATTATTTGTGTGT
AAATCATGAATGTGGCATATCTCACCA	TTTTGAGATGGGCACAGTAATGAGC
AGCAATAGATCCTTTACTGAAGAATGC	TCTTTAACATTGACAGTTTAGTTCTTGC
TCCCCACTTTCTAAATAACAAATGATCT	GAAAATGTAAATAAGGTATCGATTAAGCCG
GGAGAGTCTTAATACAAGACCTTGTTCT	GGTTACATGTATAGGTGATACAGTCTAGAA
CCGATGGATGTGACTTAAATCACCTTC	AGAACTACATATGAAATATGGGTAATGTGG
CTTGGACATTACTAAAATTGTGTGATGTT	GCATGCTGTGTATTATACTAGGAACTTAAA
CACTTCTGCTTTGCCCAAGAGCTGACAA	CCTCAAACGTCAAAGATGCAAAGCCA
ACTTGAGTGTAGAATTTACATGCTAATTAA	AACTTTGGGAGCCCCTATCATACCTCG
TGGTGTTTTGAAGTAAGCATATTCTTATT	TTATTTGAAGAGAACTCTGTATTGTTCAC
AGTTACATGGATTTGCTGCTAATATGA	TTTTTGGAGTGGAAATGCATTATTGAT
AGCTTAGACAACTTTGCACATTTCACT	TTAGAGTATTACACCTATACCTGTATATGC
GCTCAGTGGTAAGCTTAGGTACCTATT	TTGCCATCCAATTTAGCATACATAAAAT
CCCCATCATCGACTTATCAGCTTGTTT	GTCCAAAGGTGCCATATGTTCACACT
TGAACTCTTCTAATTGTAATGGACGTG	ACTAGTGAAGAACTGAAGGAGTCCTGC
GCTCCTTGAAAATACAGGTAGTAAATG	CAGTTTAAGTTTAGCTTTGTGTTAGCTTAT
GACTTTATTGAGCTTTGTTCCCCTCGA	GAGTATCATAGTTGTTCGTGTGTATATCA
TGCAATTTTCACTGAACCTAGGAAAGC	CTTCAGAACACTTTTTGTTTACATTTGAT
TCAGGTTGCTCACTGCAACAGTATATT	AATTCTGCCGTATTCTTTGCTGG
TCGTCTTAATGTTGAATAAAGCAGTTTC	ATGTCATAGTGCCATTGAACCCCACT
CATGTGTTACATCTCTGTGAAAGTTTG	GGGGGAATGTTTAAAGTATGTTGTATTGG
TTGCCCATGTACTGGATCGACTTACC	ATGTCCCAACAGTTTATGCCTCACTG
CCTGGTCGTTTTTACAACCCCAAATAG	TTAAGAGTTTAAACTACTACACGAGCA
CATAACGTTCAAGTCTGTAGCAATGCC	AAATTTTATTCTTGAAAATTTGAAGGTGGT
TAATAACTGGTACGTTCTAGAAGCAAT	TCCTGTTAATAAATTGCCTTTTTCTGTT
AAATGCCGTTTTCTTCTTGACTGTTTT	GACTTTGCCTGATACAGATGCTACTTG
CCATTGTCTTTGAGGCATCACTGC	GGGCAGTGCTAGGAAAGAGGCAAGGAAA
TGTCCTGGGAGAGACCGGCGCACAGAG	GAAGAAACCACTGGATGGAGAATATTTCA
GCTCCCCTTTCTTGCGGAGATTCTCTT	CCTTTCTGGAGCCTAAGCTCCAG
AGGAGTACAGCGCCATGCGGGAC	ATGTCCTGGATGCCGCTGCGCCTGCAGCC
TTGGTGTTGTTGATGGCAAACACACAC	GTTCACACAGCCAGCCTCTCCCTGGTA
GGCGAGCCCAGGACACAGCCAG	TGAGCCCTGTCCTCCTGCAGGATTCC
GACCAGGGGCTGCAGCCAGCCCTAT	GGGCCTGCGGCCCGGGGTCCTCCTACA
AAAATTTTAATACCAGAGAGGTTGTAACTT	CCAATATTATCTGTAAGCAATGAAAGGTA
GTTGCGCAGTTAGCAGTTATAAATAGCC	TTATTTATAGGCATTTTGGAACTGGGTAG
AGAAGATGTAAAAGCACCTTTATAACAAAA	GAACCACATGTCTTTACAGTGATTTTT
GTGCTTCTTCTGGCAGCTGGATTTTA	TGCCTTGTTTCTTGCTTTCGTATAAGC
ACATCAATACATAATAGTGAGAAATACCGA	ACTGCCTCTTGAGAATGGCTTACTTG
TACTGATGCTGTTATCCTTTATAAACAAAA	GAATTCACCTTCTACATTTCACTATGTGC
AGAATCACCATGGAGAAATTTTCCTATT	GAGCCAGGCAGATCTATAGAAAAAGAAAA
GTGTTTCTGTTGCTAAGGGCATACCT	GCAAATGCTTCAAATGATAAAGCCAAAAA
AGAGTGATGGCACTGCTGAGGCGCATT	TGTTTAGCTCTAGACTAAGTTGCTTTC
CAAAGTGAAGTACATATATTTAGCAGATCA	CAATCAGCTACAGCCAAGTTTCAAACT
GCCAATTCTACTTCTTTAGAAAACATGTT	CTTGCTAAATTAAGGCAAATGATGACTGA
CTCGAGTTCTGGTTACTCTGTTTGATTC	CAAGTAATGATTATGTACAGAATGTGCAGG
CAGAGGATGTGATCACAATTCGTAATAA	TGAATGATACAAACCTTGAAACAGAATG
GCTACCTATCTACAAAAACTCCTGGATCC	ACAAATACACGTTTCTTTAATGATATCTGT
CAGTATCTGCCATCACCTCAGCTTTTA	TTTTACCTGAGGCCTCAAAAATACTAG
ATCAAAACCAGTGCAACAGGTGGCTT	AAAATCCTGCTTCTTTACAGGTTATTGG
AAGAGGTAGGGAAGATGAGCTGCC	CATGGGACTCAAAGTTTTAGCACAAAAA
TGCTGTCCTTCAACAATTCCCTTGATG	GTTCCTTTCTCCATTTTACTTCACCTG
AAGCAGCGCCTGGATCTTCGGATCAGT	AAATTCAACAGCTTTCTTTAGTAGATACTT
ATTTACGTAAAGTTTCAGTGTCTGAATC	CTACTTCTCACCCAAACAGATAACAATTC
AAGACTTTGGGAAACACAACACTGGCC	TTTAAGGGCCTCCTAAAAGTAGACTGG
TCAACGAATTCTTTATGAATACTTAGCAG	TAGGTTTAATGAGGGTTAAGATTAGTTTTG
AGCCTCCGAGACATGCCACGTTT	CTGGGTTAACTGTTTCTCTCCTCTCTC
ACCTTTTGAATGACTGCAGTGAAGTTG	AACTGGCATGTAAGAGAAGCAAAAATTAC
CTGCAAGTGTGTCAAATTCTGTGCCT	TTCATTTGATCTCACCTATGGAGTGCA
TATGGAAGTTCTGACAAAAATCCTTCAAC	AAGTGCCTGGCACATAGCAAATCCTT
ATAGGAGCCAGGAGAGAATGACCTGTCCC	AGTTCCATGTTTCATTTTGAATTTAGAAAA
CTGCTGTCATTGCCTTCCGTTCCAGTTA	GCATGGACTGTGTTATTGGTAACAGG
CATACCTTTGAGCTAGTTCTGTCCACTG	GCATTAAGTACAAAATAGCACAATAAACCA
TTTTTAGGCATGCATGAGAGATATTCC	TAATTGCAGATTTGCATTCCAATATAATCC
AGAAAAATGAAAGATATGCTTTACAACTTG	AAGATCCACAGAACTTATAAAAACCTTTG
GAGATCTTCAGCAGTTCTTTGGTACTG	TAGGGGAGAGTGGGCAGGCTGCAGGT
GAAGTACATGGACAGGCAGACAGATAC	AAGCCAAGGGGTGCCATGCTGGCAT
GACAATTGAGAAAATTATGGGTAATTTGGG	GTAATTTTTAAAATGCTCAGGGGGTTA
TCTTCAAGTTTATGATCAATATCTGCTGC	CCTTTTAGACTGCTTTTCCAAGGAAAT
CAGCATCTTATCCGAGTGGAAGGAAAT	ACCTCCCTATAACCCCATGAGATGTG
CACCACCACACTATGTCGAAAAGTGT	GGGGCAGCGCCTCACAACCTCCGTCAT
ACTTGTGCCCTGACTTTCAACTCTG	ACCATGAGCGCTGCTCAGATAGC
CACTTGGGTGTTGTATTGTATGAGTATTTG	GTTAGCTTTTTAAAAGCACTTCAAGATTG
ACAATGGCCTTCAGTGCTCCAAGAAT	CTTCATGACAACAGCAGTTCGAGAAATC
GCAGTCATAAACCAAATGAATATGTCTTTT	CTTGTCAAGAGGTAAACTTTTGCATCAAA
CTAGGATCAGGTGCTTTTGGAAAAGTG	GTTTGCCATGTTTCAAGGCTAAAAATGG
ACGGCAACCTGGATTGAGACTCCTGTTTT	AACTCCCATTTGAGATCATATTCATATTC
TCATTATTCTTTCCTCTATCTGCAGAAC	TGGAATGTGCCAAATGTTTCTGCAGC
ATGAAATGATGAGTCAGTTAGGAATAGGC	GTGTCACTCAGCGATGAAACAGAATTC
GGATTCTGTTTGCTTTTGTATCATCAGTG	ATGCTACTATCAAACACTAAGAAAGAAAC
GATTGACTGGGATGCTTTGAAGAGGA	TCCTGCATTTTCAGAATACAAACTTGTCC
GATCTAAATCAAACTCCTCAGACCACAT	TGAAAACATTAAATGCAAACTCTGTTTTAT
GTTCCCCTACTTTAAGAAATAATTGTGGC	ACTGACTCCTCTTTTATGAAGAAATCAGC
CTCTAAACATGAGTGAAGCCATAAAAGGG	GGGTCAGTGTGTGAGAAAAGGTTTCTT
TCGTCTCACAAGATGTGCCAAGGGAAT	ATTGGAAGTTAGGATTTCTGCAGCGAG
CCTCTTATAATGGAAGAACATAAAACTCTC	GATGACAGCTCACCTGTCTAAATTCTTT
AACTGTATTCATGAAAGAGTCAATAGGTC	TGTGAAATAAGCTCACTGGCTGGGCATA
GTGTGTCTCTTTGCAGTTATGATGGTTAA	GTCACTTTGCCATGAGCATTAGTGG
GCTCTTCGCCAGTCTGGATGGCTCTCTT	CAAAGGTACCTACCTTTTGCATAGCAG
CAAACCCTGAAGAACTGTAACCAGTTG	CGTGAGAATTGGAACTCCCTTTTCAGT
GAATGCCGATCTAGATGTTTAATTGTTTC	TCAGAACACACATCACTGTCTGTAAAA
GAAATTTAAGCGCCTGATTCGAGATCC	TCTTTGCTTCCTATATATCATTATGCCTTG
TGCTTTAAAATTTTCAATGGAGATCTTACT	CTGTGCTAAACTTATTTGTCATTATGTGGA
GGCCCTAGTAAATTGCCTTAAAACTTTGC	GTAAATGAAGTATTTACACAATTTCTTGCT
CGTATATACTCAACAAGTGTTAGCTATTTT	GGAAAGTCTTTTCCCATTACATTAAGAAT
GAAAAATGCAATTTACCTAGTAATGGGTT	ACTCCCAACTCTAAATGTTATGTTATAGA
CAGAAGTATAGGGGAGCCAGATAGTTTG	GCAAAGCCCTAGTAACATATGACCTCG
CCTCTGAAAAACAGATAAGTTCTAGTCTT	CCACATTGCTTCGTGTTCATATGTTCG
TTAAAGTAAATGATTTGTGGATAAACCTGA	TTTTACCACAGCAATGTGTGTTCTTTG
GACTGTACCTACCAAAATGCTCCAATTAC	CTTTATAAGCTTAACAGAACACATCAGTT
AAGGGATGCTCAAGGACAGTTTCTTAC	CTTGAAGAACTACATTGCTTTTTGTTTAAG
TAGGGTGAAGCTCAGTTTCATCTTCCG	TAGTTGATGGGGGAGGGGAACAAACATC
TCCACTCTTTGACTGGACCATGAATC	CTCACTGAAACCTTTGTGTTTTTGTCC
TTTTTGGGGTCTATGGCCTGCTGTATG	GAAAATCTGAAAAACTGACAACAGGACC
TCAGTGTTGGTGGACAAGTGAATTTGC	GTTGGTTTTAATACTTGATTTAATCACCAC
GGAATACGTAGACATTCGGTACAGTTCA	GGCTGAAAAGCCAAAATGAAAAATTTT
TCTTATCAAATTTGATGAAAAGCGCCAAC	TGGAAAAGAGGAGACAGTCCTACTGA
ATCCACTGTTTTCTGTACCCGGAAGT	GCATTTGACCTTGTCATTCACACCAGT
GAAGCTACCTCTCAGCCTACTTTTCCT	AGATTACTTACTTTTCAGACATGGCCA
CAGGTGTTCTGACATAGCATTATCCTT	GGAACTTCTCATCAAGGCAGAAAAATCTTG
AGAGTGGCTTGCTTTGCCTGTG	AGTGTTCTAGTTAATCCTGAGCAGCTTG
TGAGTCCACCATCACAGCAAAAGC	GGCTGCATGTGTCTGCATGCTC
TAATTTTAGGTAACAGTGATGATGTCAAA	TGTGAATAAGTTTAGGATGGATTACTTAGT
AGAGGAAAGAATTTTTAATAAAAGGCAGT	CTCATTTCAAGGCAACAGAAGTCTTTAAT
TTTATTTTCTTAGTTTTTCACTGAAGAAGC	TTTGTAGGAGTACAATCAAGGGTACAG
CAAAAGCCTATCATTCTCTTAGTTTCTAA	AGGACACTTTCTTAAAGAAGGAGCACA
GGGTCAGCCGGCAGCCCCAACCCT	ACTGATAGTCATAGGTTAGCTGAAAAGAG
TGACTGAGTGACAAAGCAGCTCCTC	ATCCCCTGCCACTGTGGAGCCTGGAA
TGAGGTGCCCAGCCTAGGAATCCACATTTA	ATGTACCTGGGCAGTGGGACAGAGTCA
ATGTGATTGATGCTACGTTGACCGGCG	CGAAGTCGTGACATTTGACAAAGAGG
CCACTCTCAGGGACCACTAAATCCCT	CAGGCAGTGGGGGCTTTTGTTGCATGTA
AAATCTACGAAGAGCAGGTATGAGCTGGC	TGCCACTCTCTGATACTCTTGTCCCTT
CAATCCTGCCCTTGCTCCTTGGTTGA	CGAGCCAGGTACACGTTGTTCTTCCATT
TTGGTCTGAGGGAGAGCTGTCTTGTCA	TCCCGTATCCAGGGCCTGGGGCT
GGCCACTTAACTTCTCTGGGTCTGAGTTT	GTGGCTGAGGTCCTGTCCCAAAGCAA
GCTGTGAGAGCCTCTTCACAGAG	TTGCACCTCCAGAGCTGGTGCCCATG
TTTTCCTGCTCCTATCAGGTGTGTGTCCT	TTTCTCCTCACTTTGGCCCTGTTGCCAGC
GTAACTATTCTGCCATTCACAGTGGAAG	TTAACATCTCAAGGCCCCAGGGCT
TATTGTGTGTGAGGTGTGTGGCCAGGC	TATGTGACAGAGGCTGGGTTTAGGAG
TATTTATTCCGCTATGGGCGCCACCCCC	GGAGAAAATGGGGAATCACTCTTAGACTTC
TAGGCTCTGATCGGGCACAGCCAGT	CTATGCGAAGCACGGCATGCAC
ATTGGGGTTAGGGACTGGAGGTCAGTGA	TGAATCAGTAAGGAAGGGGCTGGGA
AAGAGCCCAGACACTGGCCCTGATTG	GAGTGAATCACTTTAGGCCAGGAGTTT
GATGTCTAGTTGGCTCTTCAGGGTATAG	CCCCTTCTTTGGCTCAGTGCCT
TTGTCCCCACCCAGCTGGTAGTAGAGC	AAGCTGAGGGTCCTGGTGAGTGTGGCA
GACTGTGAGCATGACTGACACCTCACTT	CAGAGTAGCACATACCTGGGATGCT
AGGATAGCGATTCTCCTGACAGCATTG	GGTTGTCCGAAGCTGGGGGAGA
GGGAAACGAGGGGCCTCCTCCCCCAAGAT	TGAGGCAACCTGTACCCCACCCTTGTT
AATATTGGGAGAAGGTACCATCAGCCCTGG	ATTTCCTTTGGCCAATGGAGATTTCAA
GGTGCCCTGTTATGTAAACACACAG	GCCATTCACCATCTTCTGCTGCA
GGGGGTGGGGTGTTGTGTGCAAGAT	CCCCTCAGCTGGCTCTGCCCATTGACT
CCAGCTGTGCAAGACAGCGATG	CCCTGACTACTATTCCCAGCTGCT
AGGGACAGCTCCTACAAGGGGCAAGAT	GCTCACCAACCTGTCGCTTGCCTTCT
TAGAGTGGGTCCTAGAGCCAGCGGGGG	GTCAGGGCCAGCGAGGCCTTGC
ACCCTCCTCCTCAGAGCCCTCATCTCTT	GACCCCCGCCCAGTGCTGAGTTGCACATT
AAGAGCCATGTGCCCTGGGAGCCCAGTC	ACATTGACAGCAAGCTGGCTGGG
GGTGGTTGCTGGTTCCTGGTGCCCCTATT	GTCTGGGGGATCCCAAGGTCCCAGA
TTCCCCCAGCTCCCAGCTTCCCACTG	AGAGCAGCCTGGTACCTGGGCATCTG
AGAGGTCTGGGTCCCAGGCTCCTGGTA	CTGCCCAGACTGGAGGACAGGT
TTCTGAGGCCTCATCTGTGCCCCACCTG	TACGGTGGGTCAGCTTCGAGCACAGC
GTTCTGGGTCATGGACCCAGGCTGAT	CTGGGGCTGGGGTTGGACAAGCA
AAAACACCGTAGACCCAGCCGTTTCTTCA	ACCTCTGAGGCTTCCAGGACAAC
TTCCTATTGCTAACGGCCCTCCCTGAT	GACAGTAAAGTTCGACTCTGGTTTAAAAGG
GCTGGGCTGTGACCAGCCTGTGTCCCATAA	CTGCTGGACCAGGAGGCCTTGGT
GTTGCTGCTGGATTGCCACCTGTCCTA	ATCCAGCCCCACCAGAATGTTGCTGTT
AGGGGTCAGGCGAAGACCTCCGGCTT	CCATGAGATTAGTGTGCTCCTTCTGCT
TCCCTGCCTTCTGGGTGCTAGGCTGAA	CACCTTCAGCTGCATCTGTAGGA
CGTGGGAGGAAGGTGCAGGGGA	AAGTCCCGGAAGGCTCTGTGTGCCAAG
TCAGGACCTGCAAAAGGGTAATCCCAA	GCCCTAAGAAGGGTGGCCCAGTGGCATAA
TTCTGTGCTTTGGTGGACTCCAGACAGC	TCTCTCATTGCAGGAGCGGAGTGCTG
TGCAGATCACTGCTAGGTCCCC	CTGTTCATACCAGGTGCCACCCCAAT
GTTGAAGGGAATCGCAGATATTCACTG	TAAGACTCAGGGCTGGAATGGGGTTGGCC
ATGATATTTAGCCAAAGTTCTTTGTGTCCC	AGGTGGCATGGTGCCCATGGGCTTCT
CCACTGATGCCCACCCAGCCAC	AATTGGCAATGCAGCAGCAGCTGGCAAA
TGGGGATGAGCTAGACAAGATGGAGAG	TTTGCCACATGAGGGCTCTTCTCCCA
TCATGCTCCAACAGGTCCTCAATGA	CCTCCCGTGGCCCCAAAGGAGGCCTTCT
AATTCACCATTGCTACCCCCAAGGTAGAGC	ACTGAGTGGCCCAGGAGGATCCTCCC
ATGCTCTGTCCTGGCTTTAGCC	CCCCGCAGCAGGGCCTCCCGTTCA
AAAACCTGGAGACCAATGACCCCCACTTGG	TGAGGAGCGCCCTCCCCCTGCTGCTGAT
CAGCTCAGGATCAGTATATGCCAGCA	GATCCTCACAGGGCAACTTCCCAGCTT
TCAGCCCCACCGGCCCCTGAATTGA	AAGGCCCTAGAGGATGATGAAGAGCTT
AACCAGTTGGCAGGGTAGGACCCTT	ACGGAGTGCCCCCAGGTCCCAGTCCTTT
TTCCATCAACTCCTGGACCTGAACTT	CGTTTTTACCCTGTAAGTGAGGACC
CTGGCAGACGGGTGGAAATTCC	TGGGAGCCTCCTACCAGTTGCCTGGAA
CTGTATCACTAATCCTTTTCCAGTATCACT	GTCCCTGCCCTTACAGCAGCAA
GTGAGGAAGGATAGAATTAATGCAGTGAG	GGTGGCCGGGAGAGTCGGTCATCGCTA
AGGTAGGTAGAGTGGCAAGGGATAGT	TATGGATGTGAACAGCCGGTGAGGCTCCA
TGTCCTAGAAGAGACAAGGTAGATGAAGG	TGCCGCAGGGTGTTGCGCTGGATCT
GCAGGTAAGTTGACACCCTGGAG	AGCAGTGGGGCCTCCAGGCAGCTGGG
CATTCTACTCCAATCATAGGGCTGCC	AGGAGAGGTGATGCCTGATCGCTGTGA
ACAGGGAACTTCCACCCATCGGGCAG	AATGGGTAGCTCTTTGGCGACAGCTGA
TGGGGACAGCCCATAGCTCTCC	ACTGCCTGAGGGAAAGTGAAACGCAT
TCTCTAGCCCACACTTCGCTGGGGGCT	TCAGCCTGGTCTCCCGCCACCC
TGGCATGGAGCTCACCTGCTGG	GGTAACGGGTGATGGGCAAAAAGCTT
ATTGACTCCTCGGCCCCAACCTCC	TTATTCTCGCCCACCCTCACGCCCTCA
AGGGTCGGAGGGCAGTGAGCGA	CTCTACCTGAGATGCCCGAGGGGTCA
GGAAGGCCCTAGAGGTGAAGAAG	CAGGAGCCACCCCCTGCCCAGG
AACAAAGCCCAGGTTTGGGGGCCCATA	GTGGAGGGCTGGTGTCTGGGGGT
TATCCCCTGGAGCCCCGCTTCCCCACGGC	CCTCGCTGGATAACTTGGCTGTG
AGACCAAGGTGGGCGACATAGCCCGT	CCTGGTGAGCTCTTCCTCAAGC
TGCCCAGTGCCCCTGGCTGCGGGGGAAT	ACACCCCAGCCCAGCCCCACTCACCTT
ATCTGCTTCTGGGTAGGGAGTGTGAAA	TTGAGGGTGGAGGGCCATGGGGCCTGCC
CAGCCTTAGGGCCTAGTGCTTGGTCT	GGGGGCTTTGTCAGCTGCTGGAACCTTT
ACTACCCAGGTACCTGTGGGATGAGGG	ATGGATTAGCGTGGGAACTGAGAGGGA
AGACTTGGCAGGCGACTCCTCCA	TCACCCTCCGTGGTGGGGGTTGT
AGTTTGTCTGGGGTGGGACTTGGCAT	TCTTCAGCGCTGGGAGAAGGATGAGG
CCCTGGGGCGCAGGGGCAGAGAGTCACA	GGACTGCCCACAAAGGTTACGCAGAGA
TTGCCTCCAGGATGGGCCAGTTGC	ATGCTTTGCCTCCCTCGGACTCCTGC
CAGATTGCCCAAAGGGAGTCCACCTA	CCAGAACATCCTTGAAGAGCTGCT
ATCTGTACAGCTTCTCTGGTGGGGAGT	TTGTGGAACCCCTGGCCTAGAAGGCAG
AGGTGACACCACAGGTCTACAAATGA	TGCCTGGCTTCTCAGGGTCACT
AGCATTGTCAGTGTTGGAGGCTG	TTAGACAGGATTTCCACAGAAGGTGAGGC
CAAGGCCAGGATGGGTCATGGCCACT	TGGACCATCATCTCCTATGAGCAAGA
GGCTTAGGAGCTGGCAAGTTATTTGAT	GAGGGCAAAGCCGATACACCAG
AGGCCAGGACCCTTGACCCCACCCTT	AGCTTGGCCGGCCCACCCCAACTGCAAAAA
TTACTTGCAGGTGGGTCTCAGGCTCCAAG	ATGGAGGCTCAGAAAGGAAGGAACTC
CAGTCAAGGAGAAACAGTTTTCTTCATGC	GCAGGTATCACTGTGGACAGAACGGAA
TGGGGCAATGCTAGAGAGACCCAG	AGAGCTTAGCTGAAGGGGATGAGAA
CCACAACACCAGCTGGGTCTACCA	GTCGCACCATGAAACCACCAATGCCTAT
CAAAGAGGAGACCGAGGAAAGCAAAAA	AAAAAGGGGCCTGCTGCACAGGCGGAGGT
CCCACAACCCCATCCCAGGACCTCA	TTGTCATCCTGCCACTGAGAGAGCTGAATA
GTGAAGGTTAGCTTGGGGAATCTTAGG	TCCATCTCTTCTGTCACCATACGCAG
CCCCCACCCAACATCCCACTCCCAGA	TGCAGTGGTGACATGGTCAGGTTA
AGCTGGACTTTTGTCACTGCCTTTGT	AAGCGGCGCCAACGGCGAGGACGGCTT
TAATAACTGGAATAAAGGATCTCCAAGTC	GCTGATAGCTGTCCCAGCATCGCACAATA
TCAGAGCCCCTCCTGGGCTCTCCAGA	CGGCGCAGCTCCCCAGCCCGTT
CTAACATCCGTAGAGACCCCCAACT	ACATGGTGAGCCCTGCCCTGCTGTCT
CCTCTGGATGGGATTGATGCTCC	GGTGGCCCCCACACCACCCACT
CTTTAAGTTCACTAGCCAAACTGCCAG	GGCATTCAGGTTCTGAAACTTTCTCAG
ACTCCTTCAGCATTCCCTGGTTCCC	TCTCCCTTCCCCAATGGGGGACCT
GAACGGACAGTGGTAGGGCAGGA	GGAGGGCTGATGGGTGTCTCCAGGAT
GCACATCTAATCTAAGAGCCCTTCTTTTT	TAACTGCACTGACCCTGAGCCTGTC
TGAGCTTGAGAAGCCACCCCTGTCC	ATCTGGGGAGCCATCCTTGTCGCCTCA
CCTCAGGTGCAGGGCATTGGCCT	ACAGGTGCAATTCCTCAGGCTGA
GTGGCTCCTCAGCCTGCGGAGATA	GGTGGTGGGGATGTGGGGGAGTCCTCA
CACCTGAAGAATCACCTATGTCCCC	AGGACTCGCTCATGTCCCTGCCG
AGACAGGCGTGACACCACAGGCA	GCCTCCGGTGGTGGAGACATGGGTGA
TGGGCAATTCCTCAGGTGGCGGGGACAAA	AGAGGGGCGATTCCTCCAGCGG
AGATGCCACTGCTGCCCCCACCTG	CCCCACCTGAATCATCACCTTTTTCT
GCCTCAGGTGGTGGGGACGTGGGTGATT	GGCAATGCACAAACTGTCTCTTGCCATA
TCTGTACGTTGCATGCCAAGGGCAGC	TGAGCTAGATAGGAGCATCGTGTTGT
TGCAGGGGCCCTGGTTCCTTGGGTTGCATA	GAATGCTGTGGATGGCACTGCC
TATCCGCTCCGTTGCTGAGCAGCATAC	ATTTGTTAGCTGGTGAGAGCCACAGTGCC
CCAACCTGCCAGCCCAATCTCAGTCA	GGAAGGGAGTGGGCAAAACAGGCATT
TAAAACCACCCATGGAGGAACTGCCTGCTC	TGTGGGGCGGGCTCAGCAGAACTGAA
ACAGTTAGGGACAATAGGGCAGAATC	TTTTGTTGTTTTCATGTTAACAGGCCTTC
ACTATCACGGGGCCTGCCTGGACACTG	TGTAATGTTCCATGTGCACCTGCAG
CAGCCAGCACGTTTGCGGGCAGTCAGA	ACAAAACAGGCACTCCATGGGCACAGAAT
TTTACCACTTCCCCTGCGCGACTGCCAGC	TGTTGGTCTGCCCCACTAAAATAGG
CACTGTGCTCTGGGCATAGCAG	CAGTTCAGGCACTAGCTCTGCCCCAGTATA
ATGGTCGGCAGGCGTATGGGGGCAGGAG	CTGGCTGACACTGAGGCTCTTTT
GCCCCACCTGTGAGATCCCTGAGAAGAT	CCCATTTCCTGCCCCATTCTCCTCACT
TTTGATTGGCCCCGGTGTCCAGTGGTGTCC	CCTCTTTTTGTTAATTCTTTCCTTTCTCTT
TGATAGGTCCTCACTGGGCAGCACT	CGCCAGGCCCCCAGCAACCCCATGATCT
TCTGTCCTTAGTTCTGGGAGTCCCAGG	GGTCCGGTGCGGCGTTGTGCTC
CAAATCCTCATGTGCCCTCAAACAAG	CTATTTAACACAAAGTCCACTCACCAGAC
CATTGGCAACCTTACATTTCTGGTCC	TTTATTCAGCTGATGGACCTGCAGCT
CATAGACTTAGCTCATGTCCTTGTGCC	CTATATGCCTACTAAGTCTTCCCAAGAAGC
GTGTCCACAGGGCTCAATCTTTACAT	GCTTATATAAAAATGTCACAACAGTGGTT
CTGTGAGATGGGCTCCACATTCCAACTAT	GGGTGGCCTGGCTTTTGGGGTTAGGTTTAA
ACATCGGCAGAAAGGACAGCCCTGACC	GAATTTTCCAAGGTTATTACATAGCTGAAA
TTTAAGTATTTTCAGATGCATCTGTTACT	TGATGAACGAGCTGATGATACTCTCTTC
CACAATATCTGTCATATAGTAAATGCTCAA	CATCATCATCATAATTTGGGGAGGGAG
GTAGAAGCAAACTACATTAAAACAGAGAT	CACAGTTTATATGTGCTTGATTATGAAAG
ATTTCTTCTATCCAAAGCCATCCTGTGC	TTTAAAAACAAATCAAACAGTATTCGTGT
TTCCAGTCTCCTGATGAGGAAATGAAA	GCAATGAGTATTCTCTTCATTTCAGGTCAG
AACATATCCAGTTTACATTAACAAATCTGG	TGTACTTTAGTAATTTAGATTTATGTCGCC
TTTGGCCATTGCTGCCTTGGCTGA	CTGCTTTCTTGAAGGCTATTGGGTATC
AAAGATTCGATACCATAAGGAGTTGCTGC	TGTTCACATTAAACAAAATTAGGTAAAAGC
AACCGCATATCTACTCTTTTTCTGTAC	ATTATCAGATATAGACAAAAGAGAAGGCA
ACTACCAGTATCAGTGTGTAAGAGGTT	ACATTAATGATTTGCCATCAATGCCCA
ATGATGCGCGGCCCAAGGAGGGAGATG	ACTTCTGCTTTGCAAGGGGCCT
TGTCACTAACGCCCATGGCCACCACATT	GCACGGGAAGACAGGGTCATCGGGAATA
GCAGTCCCTGCAATGACCTCTC	TATGCAGACAGCCCCAGCTGATGGCTTT
GAGGCCCTTGCGAGCAGGGTTGACGAT	CCAGCTGCTCTGCAGGCTCACGA
CCTGCATCCGAGGAGCAGGCGC	TCCTGCGTGTCACACCACCTTCA
GCACCTCGTACACCAGCCGCTCTGCAA	CCTCAGGTTCCACCCACATGTCCGTGTA
TGCTCTCTGTTGGTTGGCTAGAACC	AGCTGCCTACGCACCACCTCCAC
CCCGGCTGTTCCCACTGGGCCCCTCTGT	TCTGCACCTCCACGGCCTTGGCAGTGT
TGTGCCACCCTCACTACTCAGAGTCTG	GGGGGCTTCCAGCCTTCTGGCC
AGGGTTGGGGTTGTCAGGACAG	GCCTCCTAGTGCTCTAGGCTCCT
AAGTGTAAGCCTCGGCAAACAAGGCCT	TGGAAGTTGGAGTGCAGGTCGGG
TCCTGTTTTGTAGTCCAACCCTGTG	TCTGCTGAATGACTAGCTGCTCTGCC
TTACCCCAGAAGTAGCGGGCCCTGTGT	CCTCCAGGAGAAGCTGGAATTACACCTA
CATTAACCATTCAGCTCCTCAATCACAT	TGCAGGCTAGCCCAGTGTGTGGC
TTCCCCTTTGGGATAATATTTTAACAGCTG	CCTTTGGAGGGTCCTAAGCAGTGA
TGGGGCGCGGTCTCGAGCTCCCT	AAGCCCATCCGGGTGCTGTCTCTCT
CCTAGACCCACACACCCTGCGCACA	GGGGTCTTCCTTAATGGCTGCCT
CTCAGCCCTGGTCCGGGGAGGCCAA	CTCACGGCCCCCACAGCAGATGGT
TAAGGTGGTGGCGGGGTCATGTCTTCAG	TGCTCATGTGCGGAAACAACAACTG
ATTTGTAGGTCAGAATCATCACAATAATG	ATGGCAGGATGCAAAGCTATGTGAGTC
CCCACACCCTGTTCACTCCTTTGCTGATT	GTGGAAGGTTGTTGAGGAGATAAATGG
GAACAAAACAAAGGAAGCCACTGGAG	GTACTTCATACATGGGTTTCTGTGGGG
ATCTTTACAGCGACAGTCATGGCCGCA	GTTGTCCAGAGACATTTTCCTACGATG
GCTGGAGCTTTCGGGAAGGTTGTTGA	TCAAAGTCCTGAGTTACCTTGGTAATC
GCAAGAGAGAACAACAGTCTGGGTAAAAA	TTCAGACATGAGGGCTTCCCGTTCTGT
CAAAGAAAAATCCCATAGGACCAGACG	GTGATAACTTGAGTACCATCTCACAAAAAC
GTGAAGTGGATGGCACCTGAAAGCATT	AACTGTGTCTCAGGAAGCAGCCCCTAT
AACCCTCAACATCTGGGTTTCTGTCTC	GCAAAGCAGTGTTAATCACAAGGAAGC
TGGCTTCATTAGACCCACAGCTCTC	GAATACTGACAAGTTCCTAACCCTTTCT
TCGCCATCCAGCTACAGTGGAG	TCCTGTTCTACAGAATCTCAGAGTCGAC
GCTGGAGACCAGACTTCTATTCTTCAC	GCGTTCGAAGATGTTTCATCAAGAGATAC
TGATCCCCATGGACCGCAGCATGTTGG	TGAAGGGCCCTGACTGCTCCTTTCCGC
GACCCAGTTCCTCATAAATCTCGCG	GGTGGCAGGACAGAAGATCAGTACCAA
GAAGATGAAGCCCCTATCTTAGAGCAG	AGTCCTGAAAGCCTCCGGACTCGCA
GAGGGGATTCATGCGGTTCTCAC	AGGTGGAAGAAGAGGTCAGTCTCC
AAAATTAGTTTTTCTTGGCCTTCCTTT	GAAATGAGGAGAAATGGTCTGTGGTAT
AAGTTTTAATGAACATGAACTGGAGCCC	AAGTTCATCATTTGAAATGTTAAGTAAGC
GTGCTTCATTTTCTTCCTCCCCTACAT	CATGGTGCAACAAAAGTAAGAATCCAAC
CACCAGGCCTAAATGTGGATTTTGC	CCCCCACCAGCATTAGTATTTTAGAGT
TTTAGTATTCAGGAACATTCATGTGTTATT	CTTTAAGTCTCAAGAAATGCTACAGAGAA
AGAGACCTTGAAACGATTCATGAGACTC	GGTATCATCACACTCTGATAATGAAAGTC
GCCTGCAATTTAAAATTATACTCAGTTAAT	AAGCAGATGAAAAGAGCTATAAATTACAT
CTCTCGTATTTGAGCTTTATCATGCAATG	GAAAACAAATTGGTTATTGAAAAGTTTTGT
AGCAACAATTGGTTGTGATGTGAAAAC	ATCATCATCATAAAGGGTGTTTTTGATAAG
ACCTTCGGAGTTATGTGCAGTTTTCT	GGGAAAAATTTTTACAAAAGCCCAAAGAA
TTTTATAGGGTCTATTGCCGAAAACAC	ATAAACTAATGTGCATAGTGAAAAAGATCT
TGTGAAGTGGATGGCCCCAGAGAGCAT	TTGGTGAGAGTGCAGGAATGGGCAAG
GAGGATGCCATAGGACCAGACGT	GATGTCCCTAGCCAGCCCGAAGT
TTCACTCCAGCAGGGACTCCAAAGCCAT	TGAATGACTCCAACTACATTGTCAAGG
TAGACCTGGACAAGGAGGATGGACGGCCC	GTAGGGGAGGAGACAGAGTATGAGA
CCATGCCCTGGGCTACTTGGCTGGAGAA	AAGGAGTCATTTGAAGAAGTGGAGACAG
GGTTTCTTATCAGAAAGGGAGGTTCCA	TCTGAGCAAGGTGAGGAGGTCCCAGGG
CCCCTGAGCTCTGTCCCCCAGGCTTCAA	CCCAAAGGCTCCAGCTCCGAGGGTCTTA
AGTTCCCCCGGAACAACCTGCAGTTTG	TTTGGTCTGGGCAAGGAGGATGCTGTC
GCTGTGGAGTGATGAGCTGCCATCTCA	TCCTGGACCTTGTTTCTGACCCCCAA
TGAGCTGGAGGAGGAGAGCTCTAGTGA	ATTTCACTCAACAGCTCGGCCCAGCTCTGA
GCTGGGCGATATCCCCTTGCTC	CTGAAGGAAGGAGCAGATCTGCTGGAA
TTATACTAAACTTACTTTGACTGGGTTTG	AGCAGGCCCAAGAGGACAGGAGA
TAGGATCTGCTCCAAAGGTGGAGCCAA	TGCTCTAAGGTCTCAACAGTCAGCA
ACATGCTGGCGCTGGGAACCCTGAAG	AACAGCGTGGGGAGTGGCTCCTGGGCCT
AGACCTGCAGCACTTGGGCCTCATCA	AGGCAGCACACAAAAGGGTGCCAGA
ACTGCCTGGAGGGATGGGGTTGAC	TGCAGTGCAGTGGCCACACTGA
TTCCCCGCCACCTCCCAATCTCCCAGTA	GGTGAAGGTGTGCCTGCAGGAGAGAAT
GATTGGTGGTTTTTGCATGTCTCAATG	TCTCTCTGCCCCGCCTGAAGCCCTCTG
AGAAGCGCAGTGACCGTCACAACTTGC	TGGGCAGATGGTGAAGGGACATGA
ATCCATGGTGCCTTTTGACAGTGGCAA	CCACCCCAGGCCTGAACCCACTCACTT
TTCACCTATTGTCCTGTTCCCACTGCTG	AGGACGTAGATAGAGCAGGCAGC
TACAACTGTGTGGCTCCTGGGAAACGC	TTGGTGGAATCTGGATTGCATCCCTGT
CCAGAGCTGCCACTGTCTTCTC	GAAGGACAACTGAGGATGGTAGCAG
AAGGCCAAGCAGGCATTCGAACAGAT	CAGTCTCAGATACAGATCCTGACCCAT
ATTGAAGCGGTCAAAGCGCTCCTTCTT	GGATCTGTATCCAGTGGACTGGCCACT
GAGGTGTTTGAAGAGTTTTGTCGGGA	GAACTATGTGAGTTTATGTAGCTAGGCC
CATTCTGCCGTTTCACCTTTTCTTCC	ATCTTCTCCTTCAAGTCTTTCATTTCCC
CCTTCCTGACTGTGGGGCCAAT	AACCAGGTTGGTAGGGTGTGGGCCATG
AGCTAGGGGATGCCCGCATCGA	TATTGTTGGGGGAAATGAGGCTCGGAGAGG
GCTTGATGCTTTCCATTATCTCTGCC	CACACAGGAGTTACTCCGGCTGGTGAGAAA
GCGGATTGAGAAACTGGAGGAATACATC	AAGAGCAGAAGAAGCTAGAGGGGGAGC
GATGCAGAGCTACATACTTGCTAGTGG	CCGAACAGTCCAGGACAATCTGTCACTAA
AGCTACCCTGGCCCAGGAGCTGG	GGTCCTAAGCATTTTGGATTAGAGTTACC
GTTCTTCCAGATCCAGACGGTCCT	CTTCCAGAGCTTACCTGATTCTCCT
AAGTCTCTGCAGAATGCTCAGAAGC	TGACATCTGCTGACTTGGTCATCCCTG
TCCATGTCACCTTTACGCTTCTTGTAG	GTTCCCAGGCTTTTCACCCAAAGGAGA
AAGCGTATGGACAAGGTGGAGGATGAA	CTGTTATTCTCCTAACTTGCTTTTGTAAG
TCTCAATCTGCTGCTGCTCCCGCATCATTT	ATCCTTCAGGCGCTGGTACCGGTCA
AATATTGCGGCTGAACGCAAGGAAGCA	CTCTTTAAGCTTTACCATAATGAAGTGGAA
GGTCCCTCAGAGCCAAGAGGTAGCTT	CCTCTCTTTGGGGTTCTTCATGGCAATA
CAAGGAATTTGTCCTCAAAGCCCAG	CAGCTCTATTTGAAGAGATTAGTCGTTCT
CAAGATCAACAACAAAGTGGTCCAACT	CTAATGTAGCACCTTGTTCACTGAGCT
AGTTACGAGCTTTGATGAGAATGCCC	CACCCACCTACAATGACACGGGCAAA
ATGCCATCAGCTTTGTGCTAGGTG	TGGGAGGTGGCTAGACTAGTTGATT
GGGTCTTTACCCGCAGGTTGCTGGTTTTT	ACTACTCCTCTGTCCCCATAAAGACTG
TTGGTCTGTTCTAGGTCACTCTGGGA	CTTACTTTCAGCTCCTCTGTCAAGC
TCTTCCCCCTGCTGTGTGTAGACAGTG	AGTCCTAAGCCTAGGTCAGCCACCA
TGGCCCCACCAGAGATCACTCCTGACTT	CTTCCACGTTGTCACAGACAAGGGCATT
TTTGTGTTCTGCCACTGACTGAGCTTCTC	AGCGCCACAAGGTGTGGATTCC
AGCTTGGCCCCCTTCAGCTCCCGGAGTTT	AGTCCCGGCCTGTCTTCTCCGAGT
ATACTGGGAATTAGGATTCCTGAGCCAGC	TATTCAGTATATCAAGGAGCAGCGTGGGG
CTTGAACCGACTGGTAAAAAGTTCCAG	TTTAAATGTTTCATACCATAGCATTCCTT
ACTCAAATGTCTTACTGCTCTACAAGGG	CAAAGAATATGATGTTGCAGTACAAGC
CATGAAGAAATTCAACTTCTAGCTGTAAA	CAAGGGTCATAGACACAATTCTATCCTAA
CTTACTTTTGCTAATAACTGAGGAAGGG	TTAAGAGATGGACACAAAAATTTCACTATA
GGAGAAGAAGACACAGTTGGATGATAGG	AGATGCAGAAAAGGTGACTAACTTGTTG
GGTTTCCTTTCTTAAAATACGTTCCAAAA	CAGAGTACTGTGAAATATAAAGATCACGT
TAATAGTGGAGGTGAGTTGTGGTGTCTGC	ATGCAAGTCACAGGAACGGGGGACACA
GCAGAGAACAAACACTGCACACC	AGGTAACATGGATGTTAGCTCAAAGAC
TGCTGAAATTTTTAGATAAGGCACACA	CGTGCTTCAAGGAGAATTTTATTCCTCTT
CAGGAACTTCAAAATTCAACTTACTTATG	CCCACAAATGAACTTTGTCATTCAATACCT
CTGATGAAGATGATGCATATCAGGTATTG	TCTGTTAACAGTCAAGTCCAAAACAATTG
GCATGTCTCCATTTTCGATTCCAGTTTTC	CCCCACAACGACAACAACAAATTAGC
TACAGTGCCCATGACCTTTCAAAGTG	GTGTACTCACTATGTAATCCTTTGGCA
CTCCACTGAATATACATCAAACTACAAAT	GCAGTGCGTGAATAACAATCTGTAAAAAG
CCAAGGACATACGGTAAGAAACCTTTTT	AAATGGGTTGGCGGTGTCACACAGTA
ACTTGTTAATCATGACCACTTTAATGTGG	TTATTCCACATGTACTAAAATCCAAGAGT
TAACCTTGCTAGCACCTTAGGGCAGCA	GGGAAATTCACATAGGAATTTATGCTAGAA
CACTTAGGATGAAATTTCCTTTCTTATTCC	ATCATAGGAACCAGTTGCTAGAAGTGT
TAGGCCTTTAGTGGCACTCACAAGTAG	GGTTTGCCAGAATATGGACTAAAGATGGT
ATGATGACGATGCCTATAGCGATGTG	CTTAACTGTCCACGAACCTCACACAAT
CAGATACTTGGATGTTATAACACGGTAAG	TCCACAGTTGTCAACAACAACAAGGAG
CTGTTTGTGGTAAGCTGCATTGTTTGC	CTCTTATTTGCCCTCCATTAGAACCAGA
GAACTTGTTCACCTCCTACGGAACTAG	TTTTTCCTATACATTCATGACAGGCTGG
TCAGGAGGTTTTTACAGAAATGGAGGA	GCCAAGGCCGACAGAGGATGGG
CCAGGTGGTCTCCCAGGTTGTCACAGA	TCAACAGGTCTATCAGTCACAGAGTTC
GGCTTTTCTCTAGATAATCTCGTGTGTGTT	CTTCTGTATCTGTTTGGAAGGATTTAAAA
AGAGAATGCACACGAGGCGGCTTCTGC	TTTAAAAGGCAGTGCTTAGAACATAGT
CGGCCATACAGCTCCCGCCGCAGCTCT	TCCGTCACGGGTGACAGCTCGG
ACCTGAGTGTGTATATCTCTCTCTG	TTCAGAGAAGCCTGCTGCCGTCAGTAT
CCCTCCCTCGTCAGATCAGGCAGGAA	AGGTAACTTCCCTGCCTCCCTCCAGA
TGATCCGTGACGTTGATGTCCAC	TAAGCCCCCGATGAACAGCTTGTGGG
GAAGCTGCTGGTCCAGAGGGCGAGTGT	TTTAGGTGTTGGAAGTGGAGAGATGG
AGCTCATCAAGCCCGGCACTTGC	CCCCCAAATGCCTTCCCATGAAA
ACGCCGCTGCCTCCCCTGGCCCCACAGA	GGGCTTGTCAAGTCCATCGAGAT
AGAGAGAGGAAGAAAGAGCGCGCGGAG	TACTTGCTGCACTCGTCCCGCACGTCCTC
GATGGATTCAGATGGCCACACCCAGATAT	CTGTGGGATCAAGCAGCGGTCATTCAA
ACATGCAGGATAAGACGGAATGGAAA	ATTCATGAAGCCACAGGCATGCCTGCA
GGGTGAAGACCAGCACCTGCCCATTCA	ATTCTGGCCTGATTCACCACTGATAAC
AGCAAGCCCAATGAAATCCCTCAACA	TGTTGGGTGGGTCAGTTTGAAAGAG
GTGATGGGTGGAGCCGAGCTGGGGATGTT	GAGTGGCCATCCCAGGTCACCTGCAA
GAGGAAACAGCCATTGGTAAGAAGATC	CCAGGCCAACATCACCCTCCAG
TGGCTTCTGGATCTCCTCCTCAC	AGGCTGGTTCCATGGGATGAGG
TCCCAGACATCTGTGCCCTTGGA	GCTAAGGGCCAAAGAGGCCAAG
CCTGTGGAGCATATAAGCTGTGAGTAG	TGCGCCTTGTAGGCATTGAATGCC
AGGTCCAGGGTCTCTGTTCTCTGTCTA	TCCTGGACTTTCCTTGTCTTTGCTTTG
TCTCTTGCCTGCATTTCCTCAATCTTG	GTCAGCACTGATGTCCGCTTTGCCAA
GCCTTCAACTCCTCCACATAGAACTT	TATAGCTCCATCCAGGTGGACATAGAG
CTTACAGGCTCCACCCCTCTGGACTTATT	CTTGGTTCAGCAGATATCTACTGTGATCC
AGTCCACGGTCCCCTCTCCCCTATGC	TGTCCTGCTCCTAGAGATCTCTGCTC
CCAGCTGTGAGTCTTCTGGGGG	GAGCAAGGACTTAGTATGTATCCTTTGGC
AATGGTGGTCAAGGCCCCTTTTCCAAAG	TATGCCTCCCGTATTCCAGCCCCAGTAA
TGATAGTTAAATCTTTGGGGTGAGGAGAG	CTTTCTGGCCCTTCCTTTCAGCT
ATAGCAGGGGCTTAGGTAGAAGTTCCTTC	GCTCTGAGGAAGTCTAAGTCCAGTTTT
AAAAGAAAACTAAGAAGAGAAGACACAAG	GAACAAGAACAGGACAAGGACAGGGA
TGTCTGTTGGAGCAAAGGCACA	TTTCTCCTCAGGGTCTGTCTCACTCTCA
CGGCCCTTAGTGCAGGCTAAGGGTGAA	CACCGTCTGCCTCAGACTTCTTCCTTA
TTAAGACCCTGGCAGAGCTCAGAGACCCGC	CCTTTCTGTTAGTGTGGTCTGTAATGGT
GAAGCAATGTGGCCAGCCCCTCCACA	GGGTCCCATTTAAGCGAGCCAACT
AAAGGAAGCCTCCTAGCAGAAACCTAG	GTTTAAAGGAGAGTGTAGAGACCTGAAG
TTCAGGATGTTTCTTATCTAGTGAAAATGC	CTTCCCTTCTTTCACAGACCCTTTC
TGGGAAAATCCAATTCTCTGCGCTTG	TTGGGCGCAAAGATGGCCAGATGTT
TTGGGCCGGGTCCAGCGGGACTCTT	TTTAGCTACCACCTGGCCTGGTTCAAAC
GGAAAGAGTACAAGTCGGACACAGG	GGCTGCAGGGTGAGTGACTTGC
TGGCTGGTTTCTCTATCCTGGGAAGG	AAAGATAACACAGTCAGTCACAGGGGC
GGAGGAAGAGCCAGCTCTGTCTCCTT	CCCACCTGTGCCTCCTGGCCCCA
CAACATTGGGAATGCCATGGGG	TGAAGTGTCTGTGGCAGCTGCT
AACAGGGGTTCCTGCAGCAGCT	GATATGTTGCCAGGAGTTCAGGGCACT
TTTGCCTTCTCCCGGTTGCTCCAACT	TTTTCTGCCCTTCAGAGGTCACACCCAGAT
GCATCAGCCACAGCAGGAGGAGGAGGAAT	GGAACAGGCCATGAAGATGGTGGTCA
AGGCCCTCCAGCTTTTCTTCCCC	ATGAGGCATTGGAGGGGACAGCCTGGA
TTGATGTTGCCTGCGTCCAGTGCGGCAGC	TCTGGAAGAGATCCACAGGACTGTGG
GAGGTGAACACGGCCTTTGAGGACTT	GGATGGTGGTAGAAGCCCAGACCCTAA
ATCCTGCGTGCCTCCTCCTTCTCCCGCT	TGAGTGAGAAGGAATGGAGCAAGACA
TTCCGTGTCCCTTCTTTCCTCAGCT	CTGAGGGCAGCGGTGCTTCACCACTGA
GACCTTGAACGAGGAGAGCACTG	TCCTGACCTCTTCCCAGGCAGT
CTGTGCTCATGGCGGTGTCCAG	CAGGCCCTTGAACTCATTAGACCAGTT
GGAAGGATCCTACTTCCTAAAATCTGGC	TCACCTCCAGCACCTGTAGGAACTCC
GCCTGAGGATCCCTGGGATAGGCAGAA	AAGCGTTCCCACTCACCCTCAGTGAGTAA
TCGTCTGGGAATTCGAGAGAGGAGG	ATGCTTTCGGCCTTTGGTGTGGAGGTG
CCCTTACAATATCTCCCTTGGAGGGAA	AAAGTGGGGGTGCTGCCCTTGGA
AGAGGAAGTTCTTTCTACTTCCACAGG	AACTGAATCAAGTGAGGAAGAGGGCTC
CCCTGGCAAGCCAGGCAGACCCAGCACATT	GGGTGGGGGTCCATTGGGGTTGT
CCTGGATGAATTCTGGCCCTTCA	AACCAGGGCCCCCACCCTCCTGGGCACC
CCACCTCCGGGCCCACCAGGACCACCT	GAACAAGGTCTTCCCGAAGTGAGAA
TGGCCATAGCTCCCAGTCTCTGCAGTA	TCTTTATCCATCCGTGCTTTATCCTGAG
AGAGCCATGCCCAGTAAGGGGTTAGAA	TATTTGTCCCTCATGGCTGAACTGGGT
TTCTTAGACCTCCAGCAACACGTGTGA	TTGGTAGGACATTTCATTTTGGCTGAA
CAGCCCCACAAAGTTGATTTCTGGGTA	AATACTGTCCCATCCCAGCAGGT
AGAGTTCCGCACCCGCAAAAAGCTG	CCCATAATTAGCACTTGGTACCAATATTTG
CTGTGATGAGGTTGTGCCGCTCCTCTT	AGACCCTAATACAACACTCTTCGGAGG
CAATTTGTGTCCCACCAATACCAACTC	CATGGAAGATACAACCAGAGAAGGGA
ATCGTCAGGCTTGTCTTCTGACTTGTG	ACCAACCAGGTCTCGGAAGACG
GGGGGCAGACCCAGATGGCAGTGCTA	GCTCCTGGACTCCACTCAACACCCAAAT
TTAGTGGTAACCAGGGGCAGGGTCCCCTC	TGTCAGATGCGGGAAGCTTGAGCCCG
GTGTTGGAGAGAAGAATACTTTCATTTTGG	AGGGCTTGTTCCAGTCCAAGTTG
TGAAGGGGGAGCAGAAGCTGGCA	AGAGGGGAACCTGGAATGCATCTGG
CGCTCATCTCTGACTCGAACCCCCTTT	CTCCGGTTCTGGCTCCCATGCCAGCAT
TGGAGTAAAGATGGGGGCTGGGG	CTGAAGGGGGCACAGGAGCCTG
TCTACCCCCACCCTCATCCCCGCCTTT	TCCTTTCAGCCAGGGACAGTGCTGA
TAGCACGCCTGGGAGACACCTGTCCTG	AGCTGCAGGAAAGCACACTCTACT
TTTGCTGCTCGGTGCCACTGGGCATCTT	TTCACCTCCAGAGATACCAGCTTGGA
CCACAGCCTCTGCTGCCAGCCCCCAGT	AAGCTTCCATTGCCGAACCAGC
ATGACAAAGGGCGAGGAAGTGGAGCCC	ATCAAGGGGCATCTCGCTGCACTCAGGT
GTCTAGGTCTCAGCGCACAACCCA	CTGAACAAAGACCCCAACCTGGG
CTGGAGTATATCGTTTCACTGTGCTTG	ACTCCCACGTAGGTGCCAGGAATG
AAGGGCACTGGTGCCACGTGTGGCAAAAA	GTCCTGCCTGTTGGCTGGTCCCCGTA
AAGTCCGTGCACGGCTTCGCTGGAGCT	AACACCGGGGATAAATATTTGCCGGCC
GAGCCACCTCTGCTCTGACAGCACT	TTATATTGGACGTGGTTCCGAGCAG
CCTCTGGGGAGCCACTGGGAGG	AAAGGCAGCTCAGGCATCTTAGGCAGG
TGGAGAAGGTGGATGGTGATGTGGTCTT	AAGTGCGGCAAAGAGAAGGACAGTGAA
ACACAGCTGCCCAACAGCACTGTGTCA	ATCTTCTTGGGCGGCAGAGATTCCGTC
AGTACCGGTAGTAATTACAACGGCAAA	CTTTAATACTACCAGGAACATTTTATCACT
TCCAAACAAAATTTACTTGTAAGAAAAACT	AAACGTGCTTACATGCCACACATATC
GGTGGTAGCAGAGCTCGGAATC	AGACCTCATGGCCTATGACAGAAGAGG
CCCCCTCTAGGTGGTGGTGGTGGAGGAA	ATCATTGTAAAACCACCATAATCATAGGT
TAGTACCTCCTGATGGGGGAATGACTT	TTTGATGACCGTCGCGGACGCCCAGTG
TTTGGTGACAGCACCCAAGCTACCCA	AAGGGGCAGGTTCTGAGCTTCCCTC
AAGAATATACAGGTTAGGATGGACTGGAC	GGTCCATTCTTGTCAACACCAACCT
TGCTGAGACGCAACAGGCCATCC	GGTGTCTCAAAATCTATTTCTTCCCCTC
CCCTTGATCCTTCTAGGTGGGGA	GCTCTTCTCAAAGGGTTATTTAGTATAAG
