AAAGAATGGTCCTGCACCAGTAA	TCAGTCATTTTCAGCAGGCCTT
AAAGATTGGAACTAGGTCAGCTGAAG	AAATCTCCCTCCAAAAGTGGTGC
AAATAGCCTCAATTCTTACCATCCACAA	TCTGAGGTGTAGTAAGTAAAGGAAAACAG
AACTTTTCTTTTAGTTGTGCTGAAAGACATT	AATGAGTCATCCAGATTATCGAGTGA
AAGAAATCGATAGCATTTGCAGTATAGA	AAAGCCAACCGATACTTTTCTCCA
ACAGTTATGATTTTGCAGAAAACAGATC	TAAGTCCTGAGCCTGTTTTGTGTC
ACCAGAACGTTGTTTTCAGGAAGT	CATAGGTCTGAAAATGTTTCCTGACTCA
ACCCCCTCCATCAACTTCTTC	GGCAACCGTGAAGAAAAGATCC
ACGTCTTCCTTCTCTCTCTGTCA	GTCCATGGCTCTGAACCTCAG
AGCACTGATGATAAACACCTCAAGTT	GTGTCAAGAAGATGACTATGAAGATGAT
AGCTCTCTTGAGGATCTTGAAGGAA	CAGAGTCCTTGCAAGCTGTATATTT
AGTATTCTTTTAGTTTGATTGCTGCATATTTCA	AGAAAGACTTGAAGGCGTATACAGG
AGTTGGAAATTTCTGGGCCATGAA	GATAATGGCTTCTCTGAAGACCGT
ATGAGCTCCAGCAGGATGAAC	AAATCTTAAACTGGGAGGAACAGGATAC
ATTTTCTTTCTCTAGGTGAAGCTGTACTTC	TAGATATTCTGACACCACTGACTCTGAT
CAAGAAGTGGAGAATGTCAGTCTGAG	CATCACATGAGTGAGAGGGTCTG
CACCTCCTTCAGGTCACTGAT	CTTCCGGCGGTACACTGC
CAGAGACTTGGCAGCCAGAAATA	ACAGTCCTGCAAAGGATTTTTAGTTTC
CAGCCACACCCCATTCTTGA	AGTTTCTGGCAGCAATGTCTCT
CAGCTGGTGACACAGCTTATG	CTATGTCCACAAGGGGCTAGGA
CAGGAACGTACTGGTGAAAACAC	GTAAGGAGGTGGCTTTAGGTCAG
CAGGAAGTGGAAGGAGCTGTT	GCTGAAGTGGTCCTTGCAG
CAGTGTGTCCACCGTGATCT	TCAGGCTCATCCTCCTTCACT
CATCAAATCATCCATTGCTTGGGA	CAGAACGTTGTTTTCAGGAAGTCTG
CATGAAGGCAGGATGAGAATGGAA	GGCATCCTTGAGTTCCAAGGC
CCAGGGAGTAACTATTCCCAGTCA	TAAGTGCTTGAAATTCTCATCCTTCCAT
CCAGTTCAGGAAAATGACAATGGG	AGAAGAATGTATTATTTCTGCCATGCCA
CCCCACAGAAACCCATGTATGA	GGCTTTCCATGTCACCTTTTTGG
CCTCACCTCTATGGTGGGATCA	AGTAATCAGGGTTAATTGGCGAGC
CCTCCCCAGTCCTCATGTACT	TGTAGGAATCCTGAGAAGGGAGAAA
CGAAGTGTAAGCCCAACTACAGAAA	ACCTATACATATACCTCAGTGGGTTGT
CGACGGGAAGACAAGTTCATGTA	CATTGGGAGAAATATCCAAAATAAGGACA
CGCCAGGCTCACCTCTATAGT	CTCCTACAGGGTCTCCTGCC
CGCCTCACAACCTCCGTCAT	TGTAGGAAGAGGAAGGAGACAGAG
CGCTTCTTGTCCTGCTTGCTTA	CAGTAGATTACCACTACTCAGGATAGGA
CGTAGCTGCCCTGGTAGGTTT	CATCTGGACCTGGGTCTTCAG
CGTCTTTAACAAGCTCTTTCTTTCTCTCT	TGGTTTCAAATGAATCTGTAGACTACCG
CTACGACCCAGTTACCATAGCAATTTA	GAGGCGCTATGTGTATTATTATAGCTACC
CTCCTTTACCCCTCCTTCCTAGAG	TCTCTTGGGGTGGAGGTTACA
CTCTGGCATTCTGGGAGCTT	GACTGTAGATGGGTGAAAAGAGCA
CTGGACTATGTCCGGGAACAC	GAGATAAGGAGCCAGGATCCTCA
CTGGAGTGAGCCCTGCT	AGCAACAGAGGAGGGGGA
CTTCCAGATAGCCCTGGACAA	AGTAAATGCTGCAGTTCAGAGGG
CTTGGAGGCCTTGCAGAAGAA	TGGTGTTCAAGGTCTCCCAC
CTTTTGATGACATTGCATACATTCGAAA	AGCATGCATTGAACTGAAAAGATAACTG
GAAAGGGACGAACTGGTGTAATGAT	CTTTCCTCTTCCTGGATCTGAGAATTTAT
GACAATTCATGGCTTTTCTGTTCTTCA	ACCCAGAGAAGCCAAAGAAAGAG
GACAGTTAAAGGCATTTCCTGTGA	TTTGAGTTCCCTCAGCCGTTAC
GACCTAAGAGCAATCAGTGAGGAA	GTGCTGTGACTGCTTGTAGATG
GACTTTGTGACCTTCGGCTTTT	AGCTTAACTGTTGTCCCTTTCTAAAAT
GATTCTAGTGCATTCAAGCACAATGG	TTAAGGGGATGTTTAGGCTCTGTCT
GCAACAGCAGCATCTATAAGAATATCT	TGACGTCTGGTCCTATGGGAT
GCACCTCAAAGCTGTTCCGT	CATCTACTCCCAACCACCCTTG
GCAGTTCAACTTCTGTAACACCAG	TCAAGAGGGATAAAACACCATGAAAATA
GCATACGCAGCCTGTACCC	TTCTGCATCCACTGCTACCAC
GCCACTGACAACCACCCTTAA	TACTCCACACGCAAATTTCCTTCC
GCCATCTCTCTCCTCCTTTTTCTT	TGCTCCTCTTTACCTTTCTGTCAC
GCCTCTCCCTCCCTCCA	AAAGACAATATTGGCTCCCAGTACC
GCTGCTGCAAGAGGAAAAGTG	CTTCCTGTGGAGCAGGAAAAGA
GGATACTTACGCGCCACAGA	TGGTGAGAGCCACGCAC
GGATGTCCTCAAAAGACTTGGTGTT	CTTCCGGTAGGAATCCTGCAG
GGCAAATACACAGAGGAAGCCTT	TCTGTAAGAATCCTGGGGGTGT
GGCTCCTGACCTGGAGTCTT	GGAGATAACACAGGCCCAAGATG
GGGAAAATGACAAAGAACAGCTCAA	ATTTGGCTGATCTCAGCATGTT
GGGAAATGTGAGCCCTTGAG	CAGAAGGTCCAGCATGGCC
GGGATACGGCCAGGCATT	TCTGGGAAGGGACAGAAGATGA
GGGATGTGATGAGAGGTGGAT	CAGTGTGATGATGGTGAGGATGG
GGTGCACTGGGACTTTGGTA	TTATGACTCAAGATGGGAGTTTCCAAG
GGTGTCTCTCTGTGGCTTTACC	TACAGAGTCCGCAAGCCAAG
GTAGGCCTCCACCATGACTT	TATTTGTCCATTTTGTCATCCACCCA
GTCGAAAAGTGTTTCTGTCATCCAAA	CTGCTCACCATCGCTATCTG
GTCTATCGAGTGTGTGCATATGTGTAT	TTCCAATCCCAGGTAAGGAAGTATATAGATT
GTGCTTCTGACGCACACCTA	TCAGGCCCTTCTGTCTTGAAC
GTGGTCTCCCATACCCTCTCA	CCCTATGGCTGCCTCTTAGAC
GTTAGCTCATTTTTGTTAATGGTGGCT	AACAACTATTAAGTGAAAGTTATCTGCTTGT
TAACCCACCACAGCTAGAACTTATC	ATGTGCATATTTATTACATCGGGGCA
TCACTTTTGGGTAAATACATTCTTCATACCA	GCGTGCAGATAATGACAAGGAATAT
TCAGGAAACAAAAATTTGTGCTATGCAA	ATGGAGTTGGTTCTAATGGGTCC
TCAGGCAAAGTCATAGAACCATTTTCA	GTGTTCTGAAGTTAGTTAGCTACAACCA
TCCAAACATTATTGCTATGGGATTTCCT	GAAAAGATTTCTAAGCCACAGAAAAAGAT
TCTACAGAGTTCCCTGTTTGCAAAA	ACTTCCGAAGAAATATTCTGAACGTTTG
TCTCGTTCTGAAAAAGATAGAAGTTTGG	TGTCAGCCATTCATACCTCTCAG
TGAATTCGGATGCAGAGCTTCTT	CAGCATGTCAAGATCACAGATTTTGG
TGACTTGTCACAATGTCACCAC	ATCAGGAATCTCCCAATCATCACTC
TGAGGTGACCCTTGTCTCTGT	ACTGAATTCAAAAAGATCAAAGTGCTGG
TGCAACATTTCTAAAGTTACCTACTTGT	AAACCCTTTTGTGAAGATCTTGACCA
TGCAGAGACAAGAGGATGGCTA	GATGTTTTTGCAGATGATGGGCTC
TGGAAACTTTCCACTTGATAAGAGG	ATAAAAGTGAATCTGAGGCATAACTGCA
TTACAGTGCTTAAAAATTAATATGTTCATCTGC	AAAACAGTAGAGGAGCCGTCAAAT
TTCAACTTTGGGACAGGAGTCA	GAAGTCTCATGGAAGCCAGCC
TTCCAATGGATCCACTCACAGTTT	TCCAGCATGAGACACTTCCAAC
TTGACTTTTTGCAAATGTTTAACATAGGT	ATACCAGGACCAGAGGAAACCT
TTGCCAGTTGTGCTTTTTGCTAAA	GTAAAGCCGTGTCCAAGCTG
TTGGTCCAGCCAGGGACTA	ATAATAGTGGTCCCACTGCAGC
TTTATGGGAGGCAGAATTAATCTATATATCTCA	TTATTTGTTCAAAGCAGGAAGATCATGC
TGAGGTGACCCTTGTCTCTGT	GTCCATGGCTCTGAACCTCAG