AGTAGCCAGGACAGTAGAAGGAC	TAGAGTGCTACACTGTCCAACAC
GTATCAGGTAGGTGTCCAGCTC	AGAGATTAGTGTCAATTCATTCTCCTGG
GCAAAAGGACCCCATATAGCACAG	AAAGAGCATTCAAAGTGTCAAAGTAGGA
AAGGACCCCATATAGCACAGGTA	GAGCATTCAAAGTGTCAAAGTAGGACT
CACAGGAGAGAATATTGTGTCC	GGACATTTAGATGTAAAATCACTGC
CTGTACCATCCATTCCAGTTG	CTTATAGCAAGACCTCTCAATGG
CATCGTGGGATCTTGCTTA	GAAGATCTGGAAGAAGAGAGGA
CCATAGCAACAGATTTCTAGCC	CTACTTCCCAGGGACAAGC
GGAGTGGAATACAGAGTGGTG	CATTGACCACATCTCCTCTGA
GGAGCTTTACCTTTCTGTCCTG	CATCAGGATAAGAGAAAGAGAAGC
TGACTGAATGAATATCTCTGGTTAG	TTCACGGAGATAGAGAGGTCA
AATGCAATTCTGAGGTGTTAAAG	GTTCACACACAAACTCAGCAT
CCTCCCGCAATTCCTAGAA	TAAGAAGCTAAAGAGCCTCAGTTT
GTGGTTTTATGCAGCAGATG	GCATCTGAAATTAAATCAAATATTCC
AGTGATGTGGTGTTTTCTGG	ATCCTGCACGTTCTACACG
CATAAAACTCTTTCCAGAATGTTG	ATGGACATTCTTTTGTTGACCCTTTCT
AGGGAGATACATATGGATACACTCACAAA	CTTCTCCCTGCTCACACTTTCTT
ACCCTTTCTGTTGAAGCTGTCAA	TATGTTGCCAACACGAGCTGA
GGAACTTTCAATGCAGAGGTTGAAG	TGTTGAATTACAAAGTTCTGGTCTCTGT
CAATGCAGAGGTTGAAGATGG	GGAATGGGAGAAGTTTAATTTACAC
AATCAAAGTGTTTGTTCCAATACAGCAG	ACATCAACAACCTTAATGAGCTCCTC
CAGACTCTTCCAGCTGTTGCT	AGAAAACCATCGCCACCAATTG
AAGATGTCAGATACCACAGCAT	TAGGGTATTCACTACTTTTCTGTGAA
CCTCAAACTTGTCAGCAGAAAGG	TGCTTTGTTCTGATAGTGATAATTCAGGTT
CCACCATCTTTCAGTAATTTGC	GAAATTGTAGACATCAAGGGAAC
GGCCATGTATATGCGAATCTG	CATCGCTGTAAACAAGTTAAGG
GGAAAGAATTTTGCTTAAGATATCAG	TCTAGTTCAGCCATTTCCTGCTG
TTTTCTTGGTGCCATTTATCG	TAGAACAGCATGGGAGCCAG
TGGCTCCCATGCTGTTCTAAC	TAGCACAGGAATTGAAATCACCTAGTA
GATGTCAGCAAACCTAAGAATG	CTTCAGAGACGCTTGTTTCAC
TGAGTGGTTAAAATGTCACTCTG	TAAACGCTGCAACTTGCTG
AAGCATAAACATTTAGCTCACTTCT	AACCAATTCCTTGTCACTCAG
CGTTCCTCTTTCTTCATCATCTG	ACTGCACTGTGAAGAAAACAAGC
GGTGTTTGTATTTGCAGTCAAGTCTTC	CTGAGATGCCTTTGCCAATAT
TTGTTTCCTCACTAAGGTGATG	GCTATGCCTAGTAGACTGAGAAGG
TGTTCTTAGACAGACACTCGGTAG	AGCCAAATGTGTATGGGTGAAAGG
TCTTGGCCCCTCTTCGGTAA	CATCTAACAGGTCATCAGGTGT
TGTCATTTTCAGCAAAACTAGTATC	GGAGAGAAATCTGTATTAACAGTCTG
GACTACTTCCCATAGGCTGTTC	TTATAGACCTCAGGTTGCAAAACCC
GGATGCTTACAATTACTTCCAGGAAGA	ACCTAGTTCTGCTTGAATGTTTTCATCA
CATAGCATTCAATTTTGGCCCTCT	CTCACTGTACTTGGAATGTTCTCA
CATTTTCTCTAATGTTATTACGGCTA	TAACAAATGACTTGATGGGAAA
TCAAAGTTTTCCTCTAGCAGATTT	TGAACTGAGATGATAGACAAAACC
GTGGTGGTATACGATATGGGTTTTGTAA	CTTTCTGACCAACCACAGGAA
TGGCATTATCAACTGGCTTA	TTGGACTTTGTTTCTTTAAGGAC
CCTTTTGTTCACATTCAAAAGTG	TTGAATGTATTCTGCAAATACTGA
AAATGACTGGCGCTTTGAA	GTGTCATTTCTATTATCTTTGGAACA
CATGTCCCAATGGATACTTAAAG	GTGCTAACTTCCAGTAACGAGAT
CACACATTTATTTGGTTCTGTTTTTGCC	TAACATGAGATCTTTGGGGTCTTCAG
AGATCTTTCAGTTTGCAAAACCCTTTC	TTTGAACACTTAGTAAAAGAACCAGGTG
TTGGAAGGCTAGGATTGACAAATTCTTTA	TCCATGAGTTGTAGGTTTCTGCTG
GGCTCCAGTTGCAGGTTCTTT	TCTACTGACTACTAGTTCAAGCGCA
GCAATTCAGTACAATTAGGTGGGCTTA	TCGTTTTGAAAGCAGATTCTT
GCTTATACTGCTGCTTATAGGTTCA	CACTTGACCATTCTGCTCC
CCTTTTGTTTTATTCTCATGACC	GAAGGCCTGATGTAGGTCTC
TGCTTTCTTGATAAAATCCTCAGGAT	CTTGCCTTCTTCCGATAGGTTTTC
GATTTTCAGTTACATGGCTTAAGTTGGG	TGGAGTGAACTCTTTCACTTTTAC
CAAATATTTTGTCTTCAATATTACTCTC	CCCATCATGTGAGTCATCAGAA
CATCAGCTACTTTGGCATTTG	CTCTAGGATTCTCTGAGCATGG
TGCTGCTATTTAGTGTTATCCAAG	TGTTTCCTTACTTCCAGCCCATC
GCTGGGAGTCCGCCTATCA	GAGCTGGCATGAGTATTTGTGC
TGAGTAATAAACTGCTGTTCTCATGCT	CAGTATTTGTTACATCCGTCTCA
CATTATTACTGGGTTGATGATGTT	GTGGAAATCAACCAACTGG
CACTCTCTTTTCAGTGCCTGT	CACTATAGGGAAAAGACAGAGTCC
GGTGATTTGTAACAATTCTTGATCTC	GCTGACCAATCTTATTTAGTTAGTGA
TTAACTAAATAGGAAAATACCAGCTTCATAGAC	AAATGTACTTGTTGAAAAACAGATATTCAACT
CCACAAATACAAATTATGACCAAG	GCTTTGTCCTCAGAGTTCTCA
AGACCCTTACCCAATTCAATG	GTATGGTAAAGAACAGTCAAGCAA
ACAGTTCCAAGGTTAGAGAGTTG	GACCATCATCAGTCAGCTAACA
AGGAGGACTGCTTCTAGCCT	ACTCTGTAGAAGTCTTTTGGCACG
AGGAAGGATTTTCGGGTTC	GTTTGCATCTGTAAAATACAAGGG
TCATCTTTTAGATGTTCAGGAGAG	AAACCCTATGTATGCTCTTTGTTG
GTTTTCATGGACAGCACTTG	CTCCTGAAATTAAATTGTTTGAGA
CTTCAACAAGTTGACTAAATCTCG	GATGCAGCAACAGTAGAAAACC
TGGTTTTATAGGAACGCTATGTT	TCTGGTTGAGAAGTTTCAGCA
CACTGTGAAGGCCCTTTCT	CAACTGCCCTTAAGAGCCA
AAGCTTCTATAAAGTTAGGTGTTTCC	ACTCCAGACTAGCAGGGTAGG
GTGGAGACAGGTTCCTTGA	AACATAAGGCCTCAAGTTCG
TCTTCCCTAGTATGTAAGGTCAATTCTGT	TGACATTTTGTACTTCTTCAACGCG
ACTCTTGTGCTGACTTACCAGATG	TTTCTGTTCCAATGAACTTTAACACATTAGAA
AACGCGAAGAGCAGATAAATCCA	TACAAACCAAAGAACTAATGACAACGTC
CCTGTGTAAGTGCATTTTGGT	CAAAGCAGGTATTGACAAATTTTA
CCAAAGAGAGGCCAACATTT	ACAGTGTTGCTTAGAACCATAAAC
GTCTGTCACTGGTTAAAACTAAGGT	CAACAATTACGAACCAAACCT
CCTGCAGAAGAATCTGAACAT	CTGTACCAATCTCCTGTAAAAGAA
CCAATAATATTCAAAGAGCAAGG	GCAAACCTGTGTTAAAATCTTAGC
AAGAATGCAAATTTATAATCCAGAG	CCTGTCCACTTCTAAATTCTTGT
ACATAAAAGTCTTCGCACAGTG	TTTGGCTAAGAGCCTGGTAG
CGCACAGTGAAAACTAAAATGG	TTTGGCTAAGAGCCTGGTAGA	
CCAACAATTTATATGAATGAGAATCTT	CACCACAAAGAGATAAGTCAGG
GCTTTGTTTTATTTTAGTCCTGTTG	CATACACCAAAGTTTGTGAAGG
CCAGTGGTATGTGGGAGTTTG	ACCTTTGCCCTGAGATTTACAAATCT
CCTTAATGATCAGGGCATTTC	TCTTTAGCTACACCACCCACC
CAGGGTCGTCAGACACCAAAA	AGAAAGAGCAGATGAGGTTGATAATTGT
AGCTGAGGTGGATCCTGAT	TGAGGTTGATAATTGTCATCTCTAA
CATGTAATCAAATAGTAGATGTGCTTT	TTGAAATTGCTAACAATTTTGG
TGTGCTTTTTGATGTCTGACAAA	GCTAACAATTTTGGAATGCCTT
GGACTACTACTATATGTGCATTGAGAG	AAACACAAATCAAAGAGAAGCTGCAA
GATAGATTTATCGCTTCTGTGACAGACA	GTCACCCGTGATCTCGGTTT
TGTTTCTATGAGAAAGGTTGTGA	GGAAAGTCAATGCCAAATG
TGCTTCTGTTTTATACTTTAACAGGA	ACAGTTGTAGATACCTCTGAAGAAGA
GCCAAATGTCCTAGAAGATGA	TGAAGCAAACGCTGATGAA
AAAGTAAGAACTAGCAAGACTAGGAAA	TCAAATGTAGCAAATCAGAAGC
TGTATCTGAAGTGGAACCAAATG	CTTTCAGGTCTAAATGGAGCC
CCCTTTGAGAGTGGAAGTGACAA	CCCTATTGCATATTTCTTCATGTGACCA
TCTAAATGGAGCCCAGATGGAGA	CTTTGCCACGTATTTCTAGCC
AAAGAAAGATTTTCTTACTTCAGAGAA	CTTGCAGTAAAGCAGGCAATA
GATGAAGAGCAGCATCTTGA	CTAAAGAGACTTTCAATGCAAGTTT
AACTTCTCCAGTGGCTTCTTC	CTGAAAGTGGACTGGAAATACA
TTCAGGGTATCAAAAAGTCTATATTCAG 	TTGATAATGGAAGCTGGCC
GTTTGCTCACAGAAGGAGGACT	CATGATGAAACATCTTATAAAGGAA
TGAAGAATGCAGGTTTAATATCC	TTGAAGCAAATGCTTTTGAA
AACTAATTAACTGTTCAGCCCAG	ATGACGATTCCTTCTGTGTTT
TTAGTGAATGTGATTGATGGTACTT	GGACAATTCTGAGGAAATGTTC
AGAACCAACTTTGTCCTTAACTAGCTC	GAAGCTGATTCTCTGTCATGC
TGATTATAAAGAAGCAAAATGTAATAAGG	AAGAGGTCTTGGCTGCAG
GCAGGAAGGACAGTGTGAA	CAATCCCAGAAAAGTCTTTTATATG
CAGCATGTCACCCAGTACAAC	CAGACAAGCTCAAAGGTAACAA
CTTCCAAGGATGTTCTGTCA	AAATTATAAAAACGTTGAGCTGTTGCCA
CATGGAAAAGAATCAAGATGTATGTGCT	AGGTACAATTCAACCAAAACACA
CATGAGAGTAGCATCACCTTCA	TTTTGTCTTCCAAGTAGCTAATGAAAGGA
CAATCCAGACTCTGAAGAACTTTTCTCA	AAACGAACCCATTTTCAAGAACTCTAC
AGGAACTTCATGAAACAGACTTGACTT	TGGTTTATGTTCTTGCAGAGGAGAA
AAGCAACCCAAGTGTCAATTAAAAAA	GCAGGACTCTTAGGTCCAATT
AAATCGGACATCTCCTTGAA	AATCAAGCTCTCTGAACATAACATT
TTGGAGGTAGCTTCAGAACAG	CTCAGTCAATTAATACTGTATCTGCA
ATCAAAAGAAACTGAGCAAGC	CCATAATTTAACACCTAGCCAAA
TGTTATTTTCCAAGCAGGATTT	ACATATTGCAGAAGAGTACATTTGA
AGAAGAATCAGGAAGTCAGTTTG	GACCACTTCTGAGGAATGCAG
GAAGTGCCTGAAAACCAGATGAC	GCAAGCAATTTGAAGGTACAG
CCCATCGATTGGTCAGGTA	TTAGGGGCTTTTATTCTGCTC
TGACTGTAACAAAAGTGCTTCTGGTT	GAATATTAGTGAGGAAACTTCTGCAGAGG
GCAAAAAGCTGTGAAACTGTTTAGTGA	TGTCATGATTCTGTTGTTTCAA
CTGCAGAGGTACATCCAATAAG	TTGAAATGACTACTGGCACTTT
AATAATAAATGCCAACTGATATTACAA	CATAACTTAGAATTTGATGGCAGTG
AGATAACAAATATACTGCTGCCAG	ACTCAGATTAAAGAAGATTTGTCAGA
TGGCCAGTTTATGAAGGAG	TGATACATTTTTTCAGACTGCAAGTGG
GTTAACTGCTACTAAAACGGAGCAAAAT	TCTTTGATCAGAAACCAGAAGAATTGCA
GTGTCGCCAAAGAGTCATTTAATAAAAT	GACATAAGAAAGAACAAAATGGACA
TGCATAACTTTTCCTTAAATTCTG	AGTGACCTTCCAGGGACAA
TGAAAGAAAGTGTCCCAGTTGGT	AAGGAATCTTTGGACAAAGTGAAAAACC
TCATACAGCTAGCGGGAAAAAAGTTAAA	TCAATGGGCAAAGACCCTAAAGTAC
GCAAGGTACTAGTGAAATCACCAGTTTT	AAAACCTTGTTTCTATTGAGACTGTGGT
CCCCAAAGTGTAAAGAAATGCAGAATT	TAGAAAAAGAAACAGCAAAAAGTCCTGC
AGCTCTTAAGTGATAATTTATGTAGACAA	CATTGAAAATTCAGCCTTAGC
CCTGCAACTTGTTACACAAATCAGT	TGGCTTAGAGAAGGAATATTTGATGGTC
AAACTTCTGTGAGTCAGACTTCA	TCAAACAGTACTATAGCTGAAAATGA
AACCAGAAAGAATAAATACTGCAGAT	AACAGCTATTCCTACCATTCTGA
TCAAACAGTACTATAGCTGAAAATGAC	AGTATTGAAGAATGTTGAAGATCAAA
AATAAACTTGATTCTGGTATTGAGC	GGAACTTGTGACTAGCTCTTCA
TGTAAATGAAGATATTTGCGTTG	GGTAAAATCGTTTGTGTTTCACA
GGTAGGGCCACCTGCATTTA	GGCATTGGATGATTCAGAGGATATTCT
CCAAACGAAAATTATGGCAGGTTGTT	TTGCTGACATTCAGAGTGAAG
TGTAGCACGCATTCACATAAG	CACCTTGTGATGTTAGTTTGGA
ACCAAAATATGTCTGGATTGGAGAAAGT	GCAAGTGGAAAATCTGTCCA
TCAGTCTCATCTGCAAATACTTG	CCAAAGTATTGTTTAAAAGTAACGAA
CTGAAATAGAAGATAGTACCAAGCAA	TACAGCAAGTGGAAAGCAAGTTTC
TGGTAAATTCATCTGCTTTCTCTGGAT	AGTCTTCACTATTCACCTACGTCTAGAC
CACAAAGTTAAGGGAGTGTTAGAGGAAT	AAACCCAGAGCACTGTGTAAA
AAATACTTCCTCGTGTTGATAAGAG	CTCAATTTCAACAAGACAAACAA
AAATAACTTAAATGTTGAAGGTGGTT	TTCATGTTTTGGGAAAAGAAC
AACCAAAGTGTCACTTGTTGAG	GAAGCAGTAGAAATTGCTAAAGC
AAGATTCAGAAAACTACTTTGAAACA	TGGTTTTGTCAAATTCAAGAATT
CAAGTCATGCCACACATTCTC	CTTTCGTGTTGCCAATCACTA
AGAGGAGAGCCCCTTATCTTAG	TGTTATAAACTATGTCTTTTCAGCCA
TTTAACATTTAAAGAGTCAATACTTTAGCTTTAA	GAATTTGACAGGATAATAGAAAATCAAGAAAAA
TAGACTTTTGAGAAATAAAACTGATATTATTTGC	ATCCTTAAAGGCTTCAAAAAGCAC
TTTAGGAGAACCCTCAATCAA	ATCTGTTCTCCCTCTATAGGTATGG
TTGAGCATCTGTTACATTCACTGAAAATTG	TTTATGCATCATGTTTCTTTAGAGCCGA
TGTTTCCTAGGCACAATAAAAGATCGAA	ACACTAACGTTAAGAAGTTAACACTTCC
CAAATGAGGGTCTGCAACA	GGTCAAGAATTTCTGTCTAAATCTC
ATTGCAGCACAACTAAGGAAC	GCAGTTTCAGGACATCCATTT
AAATCTCATTTGTATGAACATCTGA	ACCAAAGTCTTTGTTCCACC
GAGACACTTGATTACTACAGGCAG	ACATTGATGGACATGGCTC
GTGTTAGGAATATTAACTTGGAGGA	TGTAACTTTCACAAAGTGTGAAGA
AGATTAATGACAATGAGATTCATCA	TTCAGTTAGATATTTCCGTTGTTAAA
CCAGGGGTTGTGCTTT	TTTCCACAGCCAGGCA
TTACAAGTCTTCAGAATGCCAG	CTCTGAAAGCAGCAGTAGGAG
CACAGCCAGGCAGTCTGTAT	CTGATGGCTTTTATGACAGAGTG
AATGAAAATTTTTGGTAAATTCAGTTTTGGTT	TATACGTATGGCGTTTCTAAACATTGCA
CTTTTTTGTGTGTGTTTATTTTGTGTAGCTG	AAGGAAAGTTTATGGACTGGAAAAGGAA
TGCAGAGTCTTTTCAGTTTCACACT	TGTATTCCCTCATCCCTCTTTCTTCT
GAATTCAGTATCATCCTATGTGGTT	AACTGGCAGCTATGGAATG
TTGGGTTTATAATCACTATAGATGGA	GCAAGTTTAAAGCATTACATTACG
CCAGAAAGGGTGCTTCTTC	TCAGTGACAGTTGCCATCC
GTTTAAACAGTGGAATTCTAGAGTCACA	TCTGTGTTTCTGACATAATTTCATTGAGC
AATGGAAAGGGATGACACA	TACAGATGGGTGGTATGCTG
TAAAACTAGTAGTGCAGATACCCAAA	TCTTCATGGAGCAGAACTGG
CAGACTGACAGTTGGTCAGAA	CAGTCATTGATTCAGTTAAATTCTAGA
GGCAGTTCTAGAAGAATGAAAACTCTTATGA	TATACCAAACTTGGATTCTTTCCTGACC
TTATTAATTTGTCCAGATTTCTGCTA	GGTTGTGTTGATGTAATTATTCAAA
TCGCTTTTCAGTGATGGAG	TGGAGTTTCGGTCTCTTGC
GTGCCTGGCCTGATACAAT	GGAAGCAGCAAAATATGTGG
AACACATTATTACAGTGGATGGAG	CAGGAGGAATTTGAAGAACATG
CCCAACAAAAGAGACTAGAAGCCTTAT	GAACAAAGTCTTAGAGACTTTGAATTTAACATT
TCCCTTCTTTGGGTGTTTTATGCT	ACAGCAAGTTCGTGCTTTGC
ACCATATTTACCATCACGTGCACT	TTGATGATTATTCAAGGTGAGAAGCTGT
TTTGTCCTGTTTAAAGCCATC	CAAATGTTGAATGATAAGAAACAAG
TCAGTGAAGAGCAGTTAAGAGC	GTTTATCAAGGGATGTCACAACC
GCTCAGATCCAGTTGGAAA	CAGGTAAGTATGTAAATGCTTTGTTT
TTGCGTATTGTAAGCTATTCAAA	TAGTTTATATCAGAGAAGCAAAATCC
TGATAATCACTTCTTCCATTGC	TCTTGCAACTTCAAAATCTAAAAG
ACTGAGTATTTGGCGTCCATC	CATACAGTTAGCAGCGACAAA
AATTTATCATCTTGCAACTTCAAA	GCTTGTTAGTTTATGGAATCTCCA
GTTTATGGAATCTCCATATGTTGA	TGAGGTGGACCTAATAGGATTT
CAGACTTTCAGCCATCTTGTT	TGATTAGTTGGAGCTACCAGTTG
TTGCATCTTAAAATTCATCTAACACATCT	TAATGAGGACATTATTAAGCCTCATATGT
CCATTCTAGGACTTGCCCCTTTC	TTTGCTGGAGATTTTTCTGTGTTTTCTG
CCAGAATCCAAATCAGGCCTTCTT	TGACAGTCCAGTATCAAGGAAATAGC
GAAACATAAATATGTGGGTTTGC	CCAACTAAAGACTGTACTTCAGGG
CAAATGATCCCAAGTGGTC	GAGGCCATCGTATATTCTGTTG
TTTCAATGAAAAGTTACTTTGATTTAGT	GGAAGTCTGTTTCCACACC
ATCAAAGTCCTTTATCACTTTGTATG	TTGGATTTCTTGAGTAGACTGCC
AAAGAGATTGATGACCAAAAGAA	TTGTGGCACCAAATACGAA
GCTGCACAGAAGGCATTTC	ATACCCAAGCTCTTTTGTCTGGTT
TCAATAGCTGACGAAGAACTTGCATT	ATCTCTGATCAAAGAACAGGAGAGTTC
CAGACTGAAACGACGTTGTACTA	CAAAGGCGACAATAAATTATTGACG
CTCTGATCAAAGAACAGGAGAGTT	ACCTTTCCAGTTTATAAGACTGGAA
CCGGTTTCTGAGCCTTCT	ATCCAAGGGAACGAGCTG
GATGGCCCTACTGCATCA	GTCAGACCGGCCTCC
CAACGCGCAGGTCTACG	CTACCTGGAGAACGAGCC
TTTCCTGCAGCCCCAC	GGGAGAAGGGAGAGCCT
ATAAAGTGGATCTGCTGCATC	GACAAGGGAAGTATGGCTATGG
CCAGGCCAAATTCAGATAATC	CATTATGGAGTCTGGTCCTGT
TGTGCAATGACTATGCTTCAG	CTAAGAGCCAAAGCGACTGAG
GTAAGGCTGAGGAAGTGATAGG	ACCAGTGCACCATTGATAAA
TCTGTCCTCTTGCTTTTAATAGG	AGGTACATCTCTCCCAGGG
ATGAAAGCTGGTTAGCTTTGA	CCAGAGAGATGATGGGGAG
CGAAGAGGAGGGAGAATGT	AGAAGAACAGCCTGGCCTT
GCTCATGATCAAACGCTCT	TGATGGGCTTACTGACCAAC
GATCCTACCAGACCCTTCAGT	ATAGCTTTTCAAGAACTTGTTGTG
ACTCCATCTAGTAGAAAATAGACCTTGTCA	AGAATGTGCCTGGCTAGAGATC
TGGATTTGACCCTCCATGATCAG	CTGTAGCTTAGGAGTAGCATGTTCTTTAC
GAATGTGAACCCTTTCATGTC	TACATCATCTCGGTTCCGC
CATGGTGGAGATCTTCGACAT	ATGCTGGATGAAATGTTTATTTG
CTCCTAGACCTCATCCTCTTTG	GACACTTTGATCCACCTGATG
TGGAAGAGAAGGACCATATCC	CACATGAGGTGAGGCATCT
CATCCTCTCCCACATCAGG	TGACAGTTCCTGGCATAGAAT
TTCCTTCCCCTTCTAGGGATT	TATGACCTGCTGCTGGAGAT
AGACGGACCAAAGCCACTTG	ACGGTTCAGATAATCCCTGCTG
ATCTGTACAGCATGAAGTGCAAGA 	CTCTACTTCATCGCATTCCTTGCA
GGCTTTCAGGACTGCAACAT	CTAACGCTTTTCCTGCCAACG
CCTCCTTACCACCACCCTCT	GATTCCATCCCCCAGAGTCTG
CGCAAATGTGGCTTTTGTAA	ATACCGGCAGCAACAGAGACG
GTGGATTTTGCCATGTAGGG	GCATGGTTCTTTTAAGCCCAG
CACTTTGCAGTCAGCCTGGT	CATTGAAAATATGTCACGAGGAAG
TCTCTTGCACAGCTGGACTG	AAAGGTGCCAGAGTTCGAAAG
TGGTATTGGCAATCGTGAAA	ACTTCCACCAAGTGAACGCTG
AACTTCTCCAGTGGCTTCTTC	CTCCTACTGCTGCTTTCAGAG
