AAGTGGCGAAGCCGTAGGTGCGCACG	TCAGCAGCAGCAGGCCCAGGACGG
CAATAGCATTGCATTCCCTGTGGTTTT	AGAGTACAGTGCCATGAGAGACCAAT
GGGTTTTCATTTCCATTGATTATAGAAAG	CTGACAATCCAGCTAATCCAGAACCA
GATAAAATCCTAGTGATGGCCGTTGTA	GACATCTACAGGTGAGTAAAG
TGCTGCCCATGTTTACAGAATGCCTT	CACCAGAACATTGTTCGCTGCATTG
GAGGGTTGAGGAGTTCAAGTTGAAACA	CATGCTTATGGGGATCAAGTAAGTCAT
ACTACTGGTATAGTGCTGGTTTGTTCA	AGAACGTTTGCCTCAGC
CATTTCAGGGTCCTGACAACTGTACAA	AACTGCACCCAAGGGTAAGCATTCTT
ATACTCTGCTATTTTATAATGAAGATGCAA	CCAGTAACATTGACAAATTCATAAACTGTA
AGGGTAAGATACATAAACACTATCAATGA	TGCCTGCCCTAGTTCCAAGATGG
TGAAAGTAATATTTGCTGTGTTGCAGG	CATTCTGTGTCAAGAAATGTCCACGTA
GCAGACTTTGATCATGGTCCTATCTCT	GACTGCTTTGTATGTCTGTGATTTCTC
AATGGTGGAGTCTATGTAGACCAGAAC	TCTTTTTAATTTCTCAAAATGTTCTACCCT
GTGGCTCTTAATCAGTTTCGTTACCTG	GGTAAGGAATATATCCAAAATGGCAAA
AAAATGGACCCCGGGGCGGTAGAGGG	ATACGGGCAGCACGACGCGCGGACT
GAACTGGGCTTAATTTTTCAAGTGGTC	AGAAGCCCATCGTGTGTCCCTGCAT
TTGATGTGCAATGCGCTCCTGTGTCAG	GTATACACTGGAAGGGCAAAAACCAA
TGGGAGTTCAAGCATCTCCTCATCTTG	ATCTGGTGGGCATAGACCTTATCACT
GGTATCCACATCCTCTTCCTCAGGATT	GTCCAACTCCATCAAATCAGCTATAAA
AGGGACAACAGTTAAGCTTTATGGTTA	AAAAATTCTTCCCTTT
ACATTCGGAGATTTGGATGTTCTCCTA	TCACGTAGGTTGCACAAAGAATTTT
CTTCTAATCCATGAGGTACTGGCCAAA	AACACATTTCAAAACACTTTTCTTCCC
GGTATGGTAAAAACATGCTGAGATCAG	CTCGTGTAGAAATTGCTTTGAGCTGTT
TAAACAACTCTGCCCCACTGCAGTGAA	CTTCAAATACATCCCACATGCACGACA
CCAAAGCCTCTTGCTCAGTTTTATCTAA	AGCCTTGTAACACATCTCCTGAAACC
CATTGCATACATTCGAAAGACCCTAGC	AGATAACTGAGAAAATGAAAGCTCAC
TTGCTGCCATTCACCTCCACGTGCTTG	TCTGTGGGGGCAGATGACGCTCAGG
GCTCAGAACCTGGTATCTACTTTCTGT	TAGCTGAGGATGCCTGCATAC
AAACAAGGCCTCAGGCGCCATCCACT	GCCAGCCCGA
CCGGAGGGACCCCCACCCCTGA	CCCCCAGCGTGAAGATCTCCCA
AAGCTCTGTGTAGCTGTCTCTCCATCT	TCGTGGGCAAACACGGAGTCG
TACCCCATGGAACTTACCAAGCACTAG	CTATAAATGACCAGGACAGGTAACTGG
GTCAGCTCCATTCAAGGGACTTCTATT	TACAATGTTCAAATGTGGCC
AACATCTCTCTTTGCACCCACCTCCGT	ATGATGTAAATGGGGCCTATGGGG
AGAGATTAAAGTGAAGGAGGATGAGCC	TTGCGAGCAGCCAGATCACGGTGGA
GTGTTTGTTGGTGCACGTGTATTTGC	CCCACGCGGACTATTAAGTCTGATTTT
CAGTATGGTGTGATGCATGTATTACCA	CAGAAGTCTTGCCCACATC
GAGAGAACAAATAAATGGTTACCTGTAAA	GTGGAATCACAAACTTTGGCAGGA
CGTAGCTGGCATGATGTGCATTATTG	ACCCATGTATGAAGTACAGTGGAAGG
GTGACATGGAAAGCCCCTGTTTCATA	TCTGTGGGGAGAAAGGGAAAAATAGAT
GCAGTTTATAATCTAGCATTGCCAAAAT	AGTTCAGACATGAGGGCTT
ACTATTTATGTAAATCAGTCTTACCAGGA	TAATGACCAGGGTGGGCCCTAAAAGC
CCACATTAGCATGATATACATACTCTCT	CTGGGAGAGATGAAACAAGTCAT
TGTGTGATATCCCTAGACAGGATTTAC	GGCTAGACCAAAATCACAAATCTTTGT
GAAGCAGGACACCAATGAAACTTCAAG	TGCCATCCACTTCACAGGTAGTC
ATTCTCCAGCCTGACTCGGGGACCACACTG	CATTTGATTTTCATTTCGACAACAGAAAAA
ATGCTTCCTTTTAAACAGGAGGAGAGC	GGACTGGTAGCCGCTTGTCTG
CTGAAGCCATAACAACAGTCTTCTGTG	ATTCCATTATGACAACA
TCCTTATTTAGCATCTCACCTCGTCAG	AGCCCAGTCAGAGACCCACGTTTT
TTTATAGACCAAAGGGGCACGATTCCG	TGTAGAAGAAGAGGAAGGTACTGGCTA
GGAAATGCATGTGGTCTGTAAACTAGG	AACACACAGTGAGCATCGAGCTCTCA
TACCATGGTAGGCTGCGTTGGAAGTTA	GACAAACCCATACCCTTGTGAAGAATG
CTGGTGTCCCTGTTTTTAGCATTAAAT	ACCTAAAAACCCAGTCTGGGAGTGAG
TCTGTGCAAAGTTATAGGCTTATTTGC	AGAACTGAACTAAATGTGGGGATTGAC
CAGTAATTGATAGGAAGAGTATCCATACT	AACAAGTGGAATGGAAC
GTTTTGTTTTGTTTTTCTGTTTCTCCCT	TATGATGGCAGGAGGGTTGTTAGTGGAGCA
CATACAGGTGGAGTATGGTCATCACAA	AAAAGGTAAGGGAAAATCTTGTCATGG
CTGTTCCTGTTTATGCCTTCATTTTTC	AGTTAGTGGTTCTGATGACAACACTT
CTGTAATTTGGGACATCTGTTAAAACAATA	GACTTCATTTCATTGC
GCAGAGCTTCTTCTAAGTGCATTTCTC	TGAAGAAGTTCCTGGATTTTCTGTT
AATTTGTTGGTCTCTCTTCTTCTTCAT	TTTGTTTCTGAACCATTGGCTCCCCGT
CTTGCAAAGTTTCTTCTATTAACCAAGA	TTCTGCTAATACCCTGCAAATAGCAGA
TGCTGGATTTGGTTCTAGGGTGCT	CCTATTTCATCTTCAGCTGATGACAAA
GAAAAGATTGGAACTAGGTCAGCTGAAG	AGCGAAATCTCCCTCCAAAAGTGGT
CTATCAAGTGAACTGACAGAAGTACATC	CCTGGCTGATTCTGAAGATAAACTAGAACC
CACCCAAAAGTCCACCTGAACACTAT	ATTATAAGCCCCAGTGATCTTCCAGAT
CTCTCTCTTTTCAGCAGTAGGTGCTT	CACTTACCATTCCACTGCATGGTTCA
CAAACCAAGCGAGAAGTACCTAAAAAT	AAAGTACTCCAGATGGATTTTCTTGTTC
CTCTGATTCTGTTTCATTCCCATTGTCATT	GTGGCAAAATGTAATAAAGTATCAGCATCT
ATTAAGAATAATGCCTCCAGTTCAGGA	AGAAGAATGTATTATTT
TCCCACCCTCAGGACTATACCAATCT	AGTTCTGCTGAGGAGTTGACGACAGGG
TCTTGGGTGGTGGGGACTATGTACCT	AACTTGAGCTCTGAGCAGAACCTCATC
GGTAGGGAAAGTTCTCACTCTGCATTA	AAAAAGAAATGTGGTTAAGGAACC
CATCGGAACTGCTGTCTGCATTTATGA	GATGATCTGCAGGTTTTCCAA
AAGCAAGGCAAACACATCCACCCAAAG	AAAGCTGTATTTGCCCTCGGGGTTCA
AACTTGGGAGACATTTTTGATCTCTGA	TGCCGGGCAGGTCTTGACGCA
GGAAATATACAGCTTGCAAGGACTCTG	TCAAGATCCTCAAGAGAGCTTGGTTG
ATGAGAAAAGGTGGGCCTGAGGTTCAG	CCTATGACAGAGAGAGAA
AGGTGAGGCAGATGCCCAGCAGGCGG	CGCATGAATGCGATCTTGAGTTTCAA
CAGCGTGGACAACCCCCACGTGT	GTGTGTGCAGATCGCAAAGGTAATCA
CCTCCCCTGCATGTGTTAAACAATACA	CCAAAATCTGTGATCTTGACATGCTGC
CCTTCTCACTGATATCGAATGCAATGG	CTTCTATCTGTGGGGAGAATATGCAGT
GCCCTGGATATTCTTTTTGAGACTGAT	GAAGAAGTCGTTGACATATTT
TGCAAAACCAAAAATAAACAACAATGTC	TTACACTTCGGGCACTTACAAGCCTA
CACAAGGGGAAAGTGTAAATCAACGTTT	CACAACCAAAATGCC
GAGGAGAAACTCAGAGATAACCAATAC	TGTCTCTGGCAAGACCAAAATCAGCA
TGACCAGGGTGAAGAGCGTGCAGAG	AAGGGCACTTCGCACTGGCCTG
ATTGCCACAGTGAGGACAAAGGGGAGT	GTACACGATGACAAAGATGATGACG
TAGCTGGGGTTTCAGCATGGGGGCAGC	AAGCCCGCACGGTAT
AACCACTGACCAAGGCTGTGCTAGAGG	TCATGGCGATGCCA
TTCAGATCCTCTGGGGCCTTTCCTTC	AGAAATATCCTGGGGCAGTATGGCTCC
ACCTAAACTCTTCATAATGCTTGCTCT	GGTCCCATCAGTTTGAACAGTTGTCT
GGTTTTCTTTTTCTGTTTGGCTTGACT	CTACAAGGGAAAGTGGCATGGTAAGTA
TTTTGAGAGGCTTGGGCTCAGCAGAA	TCACCGGCCCATCCTGCAAGCAGGG
AAGAGATCATCACTAAGGGAGCAGTGG	GGATGATGATGATGATGATGACTCCTC
TTCAGTTTCAAAAATACTTAACTCCTGTT	CTCCATAATTTAAAACCAAATG
TTGTGTGGGGGTCTGCTTGGCGGTGA	AACTGCGCCGACCCCGCCACT
ATGCATCGCCTAATGCCAGCAGACGC	TGATGTCCGTGCGT
AGCGCCTGTGTCACCCTGGGGGT	AAAACGAAGGTGAAATT
AGAATCCTTCAGAAGGCTTTTTCTTTAGAC	AACCTCCTGGACTACCTGAGGGAGT
TCCATGGCGCAGGCTGCCTGGCC	CCGTAGGTCATGAACTCAGTGATGA
GGGAAGAGCAAGAAAGAGGCAGAAAAA	TGTGTAGGTGTCCC
AGACCTGGCTTCCCACCACCCCAGGCT	AGATTGACAACCGGCA
AGTGCGAGTGGGACGGGCTGGACTGT	ACACCAACGTGGTCTTCAAGCGTGAC
ACTCGCCTCCCAGCAATTTCCTCCC	TTGCAGGTGCCATAGCCAGCTTTAAT
AAGCCTCACACCACCCCCACCCACAGAT	CCCATCTCCTCAGCTGAGATGACCTT
AGAACAGGGCTGTATGGAGCCCCCAGC	GGGAGGCGTTCTC
ATGGTGCACCTGGGATCCCTGGGAG	ATGTTTCTGGCTGCCAAGTCCCGATGAA
AATTCCCTGGCCAAGCTGCACAGACGG	CCATTTAACTGGAATCCGACCCTAAAG
TACGGACATTTTCGCATCCGTCTACTC	ATGATGGCTGTCATGTCTGGGAGCCTG
TGGACTTCTTGACTTAATCGGTTTAGG	CTTGTAATGGTTTTTATGCTTTGAATC
GGATGAGAATTTCAAGCACTTACTGCA	TGGGAATAGTTACTCCCTGGTGGACA
GGGTCCTGAATTGGAGGAATATATCTTCAC	ACACGAAATATGGATTCTGTATCTGC
CAGTTTGTGGTCTGCCAGCTAAA	AAAGGTTTGTACTTTACTTTCAT
AATTTGGAGAAAAGTATCGGTTGGCTT	AGGTTTCCTCTGGTCCTGG
AAAATGATCTTGACAAAGCAAATAAAGAC	CTTGCTTGACAAGTTTTTAACTTATGTATT
CTAACAGTAGCTGCCCATGAGTTAGAG	TTCTTGGAGCCTGCACACAGGATGGTG
GCCTTTTGGTTCCTTTGGTTGTGCTAT	CATAGGGGTCTTCTTAATCGCCTGT
CACGTGGAAAAGAACGGCAGTAAATAC	GGAGTTGAGAGAGGATGATTCTCTTTT
TTTAGATTCAGAAAGTCCTCACCTTGAG	CTCCTCCGACCACTGTGGAGGCATTT
ACTGACAGCCCTCTGGACAACACAGCT	CGTAGAGTTTGTCTGCAAGGTTTACAG
TACCAGGGAGAGGCTGGCTGTGTGAAC	AGTACAGCGCCATGCGGGACCAGTAC
CTGCCCTGTGGGGCCTGGGGCTGG	AAGAGTGCGCTGACCATCCAGCTGATC
GAAAGGAATAGTTGCATGTACAGAGTC	GATATCTGCCATCAATTCAATCAAATTTT
TTGCTAGTAATAGGTTTGGGGGTAGAC	GATCAAAATCATTCTGTGACTTCTGAA
AAGCTATAGCTTAAAATGATAAAGAGCAT	ACAAAGAAAAACAAAAAGCTTCACTTAGA
ACTGCCAAATCAATATAAAGAAGTAAAAGA	GATTTCCATTAGTATCATCTT
TCGAATAAATAGCCTTAAAACTTAAAGGTT	ATCCCACTGTCTCTGGTACCCTCATAG
ACTCACCAATCTTCTACCAGTGTGTTA	ACTTCTCCCAAGCAGCTTCCAACAGCC
ACAGAACTGTTTTAGATATGCTGGGTA	AATGTTTTTCAAACAGGTAACAGCTGC
CAGGTCATAAACAAGGAATTATATCAGACT	ATATCATCCAGG
CCCTTATTGAGACAATGCCAACATTAA	CTAGATAATTTAAATCCAGCCA
CAAAGTCGGAATACCCACATATCATGT	CCTTTACTGTGTATCTTGCATAGAATAAT
TAGGTTGAAACATATGAAATTTGCCAA	GGGACAACAACATCTTCTAAATTCTTAAG
GACAAAATCCCAAATAAAGCAGAAAGAA	CCTGCTAAGCGAAATT
CACCCAACCAAATGGCATCTTTTATAT	TTGTCTCAGGTCATCACGGCCCTTC
CTAGGACAACTGTTTATGCTGAAAACA	TCTATATGTACAAGTTCTGCT
GCTAAGTGCACAATCTCCTCCTTTCT	AACAGAGTTTCCTGA
TGAAGATCACACCCAAGCTTTCCATC	TCAGCTACTTTGTTGAAACTCTGGTCA
TCTTTCCCAGAGAACAAATTAAAAGAGT	AGACAAGACAGGTAAGTAACACT
TTGTTGTTGAGTTGTATATAACACCTTTT	AGTACAGTGCAATGAGGGACCAGTAC
GGTACTGGTGGAGTATTTGATAGTGTAT	GCTAATTCAGAATCATT
TACTGACCTTTCAGAGGTAGGATCTGC	GTGTTCTGAATCTTG
CAAGAGGCCTAGCAAGAGAATGAGAAT	TCTGAGACCGCACCATCTGGATGGTT
TTGCCGCAGCCCAGACCAAACCAGCA	TTGAAACGGTTCCTCCGCCCCTTCTT
ACATACCACTTACCGTGGACCTTACT	CGGTTGGCAAACCAGTTGTAGACA
CACATCACAGTAAATAACACTCTGGTG	TTGTCAGGGGCAATGTGAGGCTGCTATT
ACTTGAGTTTTACATTTTTAATGCTCCT	TGTCAGGTAACCCACTTCCACGAAAA
CTATCTGCAGAACTGCCTATTCCTAAC	TTCCAAGAGAAAATTTAGA
CCAGGTCCAAGATGGTAATGGGTAT	ATACCAATACTTTGTGAAGCCAAGGTGG
CCTTTCCAATTTGCTGAAGAGTGCAAA	CAGTAACCTTAAAAATTTGTGTTATTTCGT
GCTAACAGTTAATAAGCCAAGCAGAGA	AAATGTGATCCAAGAAACTTTTAGCAC
ACATAAAGAAACGTGAACAAATCTGAAA	GGTGTTCTCTGTGTTTCAAAACTAAATAA
TTCCCTATATGTTCTTGAGGTAGATGT	AATGTTTTATCATTTCTCTTGTCAAGTTG
TTTGCAGTTTGAATGGTCAACATAACA	TAAAGGTGAATCCTATATGAAACATGATG
GAAGTGCTTGATTTTCTTACTTGGTCC	TAGGCTAGCCGATACACTGTGGGAATA
GGAAAATTACCTACCTCCTGAACAGCA	AGTAGTCAGAATTTTATTACATGGTTTTGT
TGTTTTGGTGGACCCATTACATTAGAT	CTTTGATCAAAACACGTTTGAATGTCT
TCTGACGGGTAGAGTGTGCGTGGCTC	GCTCCCCTCAACAACTTCTCTGTG
GGCGGTGGTGGTGCCCCACTGT	CTTTGAATCGGGTGTCGAGGGAAAAA
ACATTCTCTAGTCTGGAGAGAGTTTTC	TTGGTGTCAGTGACTGTGATCACAGCT
CATCTTGCCAGGTACCATACAAACCTT	CACTTTCAGTGTGGTGATTACGACGTT
ACTAAATGCATGTTGCTTTTGTACCGT	AGAGCTGAATGAGGCCTTGGAACTC
ATCCTGAGTAGTGGTAATCTACTGGGA	AGGTAAGCAAGCAGGACAAGAAGCG
AAAAAGGCCTCCCCTGCTTGCCACAGG	ATCATCACACTGGAAGA
TTTGGATGACAGAAACACTTTTCGACA	CCTGCTGCTTATTTGACCTCCCTATAAC
GACCCCAGTTGCAAACCAGACCTCA	TGAGGAATCAGAGGCCTGGGGA
TTGTGAGGCGCTGCCCCCACCATGAG	GCATCTTATCCGAGTGGAAGGAAATTTG
CGTCTCTCCAGCCCCAGCTGCTCACCAT	CCACAGCTGCACAGGGCAGGTCTT
GCATGTTTGTTTCTTTGCTGCCGTCT	TTGATTCCACACCCCCGCCCGGC
AGATGAAGCTCCCAGAATGCCAGAGG	TTCTTGCATTCTGGGACAGCCAAGTCT
ATGGTGTTGGGGGAGGGGGTTCCTTCT	CCCCTCTGAGTCAGGAAACATTTTCAG
CATATCTCCCCAAACCCCAATGAAGAG	CTTTGATGGCCACTGGAATTTTCACA
ATACACCAGTTCAGCAGGTCCTGGGAG	TATGCTTCCTGGGG
TCTGCTCCTTGGTCCTTCACCTAACCT	ACATCCTCCAGGTAGCTCATCCCCT
TACAAAAATTGAAACACTATTGAGATCCT	CGCATACTGACAATATTTAACATGTTTTAG
ATGTTGGGAAAGTTGGCAGTGCTGGTA	CAAAGTCATGCACATATTCATCCTTCAC
GCTGTCTAAAAATTAAGGCCCACATGG	TGATGCTATCTGCAACAGTC
ACTCATGTCATGATGAGTATTGTACTC	AATGCAAGCTCATTGTGAACAGGCCCT
CAATACCTTGCTCTCTCAATGGCTTCT	AGTAAGCAATGGAACACCAAT
GCACTTGGGTAGATCTTATGAACAGCA	TGCCTATGTGCAACCTTAGGAAGAAA
AAAGAATGAAAAGCATACTTACTGATAGC	CTGACGCAAATCAAAGACCTTTTAAGAA
GCATGGTATGAAGTACTTCGTCTAGGA	AAGGTCATCAACACCAATTCCAGCAG
CGCAACTTCTTCTTCTTGAGGATCTTG	TAGATGACCTCGGTGGAGTCGATGCGG
AAAGCCGGGGAGCCCTGGCTGGTC	AGATTTTGAGGGTGCCACCGGTGGTG
TGTACCCCTTCGAAGGGGACAACATCTA	GCTTTTGTGCAGAAATGTAGGGTTGG
ACATCCTGGCCGAGTCAGCAGAGCC	ACCGGTCCTTGGTGTCT
ATCCCTGATCCCACTTTCATTCCCTCA	ATGCCCATCAGTGCCCTGGATCCTG
TAGTGCTGTGTGCACTAATGGCAGACT	AGCTTGATGAGCCA
AAAGAGGAAGGGCCTCGCCCCTGGCAAT	TACTGGGGCTCGGTG
ACAGCTGGTTATTCCAGAGGGACTGGG	GCGAAGCAGGTCCTGAAACAAAATTGA
GCGAGTGGTTTTGAAACAGGTTTACA	ACATACGGAGGTAGTTTC
TTGTGGGGAGCACAAGGTCAAAGCAG	ATGCGGTTCCTGTTGATGGTTGTGGA
ATGTCCTGCGTGTCAGGTCCAGAATCT	TTCTGCCCATCGATCTCCATGTCCAG
ACTCCACCCCCACCCGATCCTCAGGA	TGTTGGCAAGACGCCTCATCCGCCTGG
AGTGCGCGGTCCACCCCCTCCT	CTGCCCACCCAGCAGGACGTGCT
CGGCACACCGGGCAAATGAGCC	TAGCCCAAGGTGGCGATGCGGTC
TCCTGCTCCAGCCGATGTCAGTCT	GATCCACTGCTTTGAGAA
GGATGGAGGAGAGCAAAGCCCTGTT	CATGGGGAGGGGCT
AACATCTTCAGGATGAACTCCCGCGCC	ACGGCCCACCCAGCTCGACCCCC
AGGTCCCCAGCGGGACGCCCAG	CAGCTCAACCTCAAGGAGTACA
AAAAATCTCCTCCCGCGGGCAGAG	AGGATGGTGTCCTTCACGGCCGC
CATTCTCATTGTGTCTTCCCTCCTCTA	GTAACTGAGTCCATGAAACCT
GCTTAGTGAATATGATCAAGTTCTCGTGG	GCTTTCTTGAAATTTGATTTTAGGACTTTT
AGATAATAAAATGATAATCCATTGCCTGTC	TTGGCCCCCTACATCGACCATTCT
ATTGAATTGACTTGGATGATCATCGTC	GGTCAGAGAGAAGAAAATGGATACACT
GAAAATCATGTATTCCCATCTAGTCGACT	TTGCCCTGTGCAGCCTGCGTGTTGA
TTCACAGCTACTGAGCTGTGGTATGA	AGGGGTATGTGATAATTGTTCTAAAGAGAG
GGTCGTATACAAAAGATGGGTTGGACTTAT	GTTCCAGAACTCCTCGGTTATTC
ACCATCCTCCAGTTGAACCTGAAGG	TTTATTGCCGTCCTGGACTCTGTGTGAGCG
CAGGGAAGGGCAGGGCGGGTGTCTA	ATAATTTTGTCACTGTCTGGGTTCAGG
CCAATGATGATTGAATACATTAGCAGAT	TACTCCCACTTCACGTGCGCCACAGAC
